案件, 縣市, 鄉鎮市區, 同意票數, 不同意票數, 有效票數, 投票權人數
c07, 全國, , 7955753, 2109157, 10064910, 19757067
c07, 南投縣, , 187162, 41641, 228803, 427089
c07, 南投縣, 中寮鄉, 5701, 1272, 6973, 13181
c07, 南投縣, 仁愛鄉, 5087, 1090, 6177, 12589
c07, 南投縣, 信義鄉, 5246, 1259, 6505, 13299
c07, 南投縣, 南投市, 39753, 8588, 48341, 84328
c07, 南投縣, 名間鄉, 14946, 3387, 18333, 33408
c07, 南投縣, 國姓鄉, 7165, 1490, 8655, 16597
c07, 南投縣, 埔里鎮, 30711, 6093, 36804, 68763
c07, 南投縣, 水里鄉, 6511, 1422, 7933, 15458
c07, 南投縣, 竹山鎮, 18659, 5202, 23861, 47034
c07, 南投縣, 草屯鎮, 37026, 8133, 45159, 82922
c07, 南投縣, 集集鎮, 4068, 1045, 5113, 9611
c07, 南投縣, 魚池鄉, 5746, 1277, 7023, 13958
c07, 南投縣, 鹿谷鄉, 6543, 1383, 7926, 15941
c07, 嘉義市, , 86276, 24205, 110481, 221553
c07, 嘉義市, 東區, 39258, 11159, 50417, 100647
c07, 嘉義市, 西區, 47018, 13046, 60064, 120906
c07, 嘉義縣, , 155084, 42921, 198005, 442775
c07, 嘉義縣, 中埔鄉, 12785, 3594, 16379, 39139
c07, 嘉義縣, 六腳鄉, 5958, 1540, 7498, 20821
c07, 嘉義縣, 大埔鄉, 1555, 392, 1947, 3999
c07, 嘉義縣, 大林鎮, 9837, 2605, 12442, 26922
c07, 嘉義縣, 太保市, 11773, 3217, 14990, 31568
c07, 嘉義縣, 布袋鎮, 7992, 2087, 10079, 23965
c07, 嘉義縣, 新港鄉, 9871, 2914, 12785, 27342
c07, 嘉義縣, 朴子市, 12753, 3455, 16208, 35191
c07, 嘉義縣, 東石鄉, 5735, 1576, 7311, 21915
c07, 嘉義縣, 梅山鄉, 6588, 1785, 8373, 17083
c07, 嘉義縣, 民雄鄉, 22895, 6700, 29595, 61209
c07, 嘉義縣, 水上鄉, 16150, 4702, 20852, 43857
c07, 嘉義縣, 溪口鄉, 4446, 1304, 5750, 13105
c07, 嘉義縣, 番路鄉, 4089, 968, 5057, 10156
c07, 嘉義縣, 竹崎鄉, 11147, 3039, 14186, 31228
c07, 嘉義縣, 義竹鄉, 5818, 1526, 7344, 16647
c07, 嘉義縣, 阿里山鄉, 1295, 297, 1592, 4691
c07, 嘉義縣, 鹿草鄉, 4397, 1220, 5617, 13937
c07, 基隆市, , 121863, 31714, 153577, 320030
c07, 基隆市, 七堵區, 17808, 4870, 22678, 46256
c07, 基隆市, 中山區, 15400, 4324, 19724, 41856
c07, 基隆市, 中正區, 15640, 4183, 19823, 45545
c07, 基隆市, 仁愛區, 14062, 3933, 17995, 36738
c07, 基隆市, 信義區, 18410, 4250, 22660, 46014
c07, 基隆市, 安樂區, 27453, 6944, 34397, 70396
c07, 基隆市, 暖暖區, 13090, 3210, 16300, 33225
c07, 宜蘭縣, , 153113, 42257, 195370, 386089
c07, 宜蘭縣, 三星鄉, 6988, 2021, 9009, 19051
c07, 宜蘭縣, 五結鄉, 13493, 3720, 17213, 34892
c07, 宜蘭縣, 冬山鄉, 17752, 4886, 22638, 45405
c07, 宜蘭縣, 南澳鄉, 2007, 429, 2436, 4644
c07, 宜蘭縣, 員山鄉, 10584, 2958, 13542, 28131
c07, 宜蘭縣, 壯圍鄉, 8549, 2410, 10959, 21447
c07, 宜蘭縣, 大同鄉, 1644, 443, 2087, 4935
c07, 宜蘭縣, 宜蘭市, 32624, 8812, 41436, 79167
c07, 宜蘭縣, 礁溪鄉, 11862, 3428, 15290, 31084
c07, 宜蘭縣, 羅東鎮, 24091, 6724, 30815, 57686
c07, 宜蘭縣, 蘇澳鎮, 13719, 3778, 17497, 34512
c07, 宜蘭縣, 頭城鎮, 9800, 2648, 12448, 25135
c07, 屏東縣, , 259443, 70573, 330016, 711720
c07, 屏東縣, 三地門鄉, 2295, 606, 2901, 6373
c07, 屏東縣, 九如鄉, 7108, 1976, 9084, 19132
c07, 屏東縣, 佳冬鄉, 5700, 1644, 7344, 17063
c07, 屏東縣, 來義鄉, 2655, 554, 3209, 6257
c07, 屏東縣, 內埔鄉, 15808, 4258, 20066, 47558
c07, 屏東縣, 南州鄉, 3479, 966, 4445, 9479
c07, 屏東縣, 屏東市, 66120, 17114, 83234, 170148
c07, 屏東縣, 崁頂鄉, 4496, 1231, 5727, 12270
c07, 屏東縣, 恆春鎮, 8909, 2055, 10964, 25661
c07, 屏東縣, 新園鄉, 10874, 3150, 14024, 30706
c07, 屏東縣, 新埤鄉, 3096, 909, 4005, 9033
c07, 屏東縣, 春日鄉, 767, 215, 982, 3923
c07, 屏東縣, 東港鎮, 14549, 3955, 18504, 39495
c07, 屏東縣, 枋寮鄉, 7667, 2168, 9835, 21394
c07, 屏東縣, 枋山鄉, 1689, 484, 2173, 4856
c07, 屏東縣, 林邊鄉, 5897, 1721, 7618, 15691
c07, 屏東縣, 泰武鄉, 1895, 515, 2410, 4344
c07, 屏東縣, 滿州鄉, 2211, 556, 2767, 7206
c07, 屏東縣, 潮州鎮, 17240, 4550, 21790, 46444
c07, 屏東縣, 牡丹鄉, 1348, 280, 1628, 4314
c07, 屏東縣, 獅子鄉, 1409, 287, 1696, 4230
c07, 屏東縣, 琉球鄉, 3306, 726, 4032, 10706
c07, 屏東縣, 瑪家鄉, 2394, 657, 3051, 5663
c07, 屏東縣, 竹田鄉, 6113, 1793, 7906, 15353
c07, 屏東縣, 萬丹鄉, 15892, 4655, 20547, 43478
c07, 屏東縣, 萬巒鄉, 6002, 1899, 7901, 17945
c07, 屏東縣, 車城鄉, 2167, 580, 2747, 7595
c07, 屏東縣, 里港鄉, 8226, 2453, 10679, 22128
c07, 屏東縣, 長治鄉, 9969, 2844, 12813, 26256
c07, 屏東縣, 霧臺鄉, 1151, 301, 1452, 2950
c07, 屏東縣, 高樹鄉, 6898, 2226, 9124, 21697
c07, 屏東縣, 鹽埔鄉, 8036, 2168, 10204, 22402
c07, 屏東縣, 麟洛鄉, 4077, 1077, 5154, 9970
c07, 彰化縣, , 452334, 111030, 563364, 1066994
c07, 彰化縣, 二林鎮, 16535, 3868, 20403, 42976
c07, 彰化縣, 二水鄉, 5683, 1607, 7290, 13339
c07, 彰化縣, 伸港鄉, 13300, 2650, 15950, 30407
c07, 彰化縣, 北斗鎮, 11915, 2859, 14774, 27593
c07, 彰化縣, 和美鎮, 32445, 7579, 40024, 75286
c07, 彰化縣, 員林市, 43129, 10985, 54114, 102028
c07, 彰化縣, 埔心鄉, 13153, 3544, 16697, 29642
c07, 彰化縣, 埔鹽鄉, 12676, 2865, 15541, 28026
c07, 彰化縣, 埤頭鄉, 9819, 2728, 12547, 25677
c07, 彰化縣, 大城鄉, 4053, 953, 5006, 14713
c07, 彰化縣, 大村鄉, 13893, 3300, 17193, 31492
c07, 彰化縣, 彰化市, 85910, 21752, 107662, 190995
c07, 彰化縣, 永靖鄉, 13632, 3376, 17008, 31239
c07, 彰化縣, 溪州鄉, 9269, 2429, 11698, 25405
c07, 彰化縣, 溪湖鎮, 19566, 4696, 24262, 45147
c07, 彰化縣, 田中鎮, 14996, 3604, 18600, 35391
c07, 彰化縣, 田尾鄉, 10126, 2487, 12613, 23179
c07, 彰化縣, 社頭鄉, 15452, 3889, 19341, 36306
c07, 彰化縣, 福興鄉, 15627, 3996, 19623, 39745
c07, 彰化縣, 秀水鄉, 14290, 3569, 17859, 32394
c07, 彰化縣, 竹塘鄉, 4837, 1264, 6101, 12821
c07, 彰化縣, 線西鄉, 6361, 1367, 7728, 14065
c07, 彰化縣, 芬園鄉, 8346, 1976, 10322, 20408
c07, 彰化縣, 花壇鄉, 16953, 4059, 21012, 38924
c07, 彰化縣, 芳苑鄉, 10149, 2400, 12549, 29291
c07, 彰化縣, 鹿港鎮, 30219, 7228, 37447, 70505
c07, 新北市, , 1346167, 373414, 1719581, 3375513
c07, 新北市, 三峽區, 35739, 10099, 45838, 94291
c07, 新北市, 三芝區, 6999, 1927, 8926, 20119
c07, 新北市, 三重區, 128111, 39417, 167528, 329846
c07, 新北市, 中和區, 146208, 37338, 183546, 355978
c07, 新北市, 五股區, 27379, 7871, 35250, 72443
c07, 新北市, 八里區, 12684, 3493, 16177, 32970
c07, 新北市, 土城區, 78924, 22140, 101064, 200783
c07, 新北市, 坪林區, 2075, 535, 2610, 5891
c07, 新北市, 平溪區, 1428, 412, 1840, 4321
c07, 新北市, 新店區, 113797, 26226, 140023, 264053
c07, 新北市, 新莊區, 140045, 41204, 181249, 344981
c07, 新北市, 板橋區, 183642, 54962, 238604, 463411
c07, 新北市, 林口區, 36042, 9434, 45476, 86203
c07, 新北市, 樹林區, 60667, 17206, 77873, 152102
c07, 新北市, 永和區, 83228, 20414, 103642, 187798
c07, 新北市, 汐止區, 67547, 18065, 85612, 173831
c07, 新北市, 泰山區, 26020, 6947, 32967, 64252
c07, 新北市, 淡水區, 56960, 15439, 72399, 147272
c07, 新北市, 深坑區, 8193, 2201, 10394, 20624
c07, 新北市, 烏來區, 2072, 470, 2542, 5264
c07, 新北市, 瑞芳區, 12211, 3277, 15488, 35036
c07, 新北市, 石碇區, 2358, 719, 3077, 6861
c07, 新北市, 石門區, 3899, 1018, 4917, 10528
c07, 新北市, 萬里區, 6883, 1811, 8694, 19297
c07, 新北市, 蘆洲區, 62988, 19193, 82181, 167457
c07, 新北市, 貢寮區, 3309, 1075, 4384, 11279
c07, 新北市, 金山區, 6853, 1860, 8713, 18978
c07, 新北市, 雙溪區, 2739, 737, 3476, 7999
c07, 新北市, 鶯歌區, 27167, 7924, 35091, 71645
c07, 新竹市, , 147391, 39438, 186829, 351775
c07, 新竹市, 北區, 50916, 13514, 64430, 123122
c07, 新竹市, 東區, 69070, 19030, 88100, 163757
c07, 新竹市, 香山區, 27405, 6894, 34299, 64896
c07, 新竹縣, , 191602, 45444, 237046, 445051
c07, 新竹縣, 五峰鄉, 1242, 331, 1573, 3997
c07, 新竹縣, 北埔鄉, 3535, 782, 4317, 8180
c07, 新竹縣, 寶山鄉, 5773, 1417, 7190, 12973
c07, 新竹縣, 尖石鄉, 2358, 565, 2923, 7364
c07, 新竹縣, 峨眉鄉, 2238, 570, 2808, 5068
c07, 新竹縣, 新埔鎮, 12327, 2899, 15226, 28894
c07, 新竹縣, 新豐鄉, 19499, 4612, 24111, 45790
c07, 新竹縣, 橫山鄉, 5073, 1166, 6239, 11346
c07, 新竹縣, 湖口鄉, 27505, 6227, 33732, 63511
c07, 新竹縣, 竹北市, 61066, 15029, 76095, 137129
c07, 新竹縣, 竹東鎮, 32641, 7500, 40141, 78794
c07, 新竹縣, 芎林鄉, 7631, 1895, 9526, 17293
c07, 新竹縣, 關西鎮, 10714, 2451, 13165, 24712
c07, 桃園市, , 697528, 173333, 870861, 1801823
c07, 桃園市, 中壢區, 134509, 31525, 166034, 334402
c07, 桃園市, 八德區, 62058, 15724, 77782, 165065
c07, 桃園市, 大園區, 26894, 7155, 34049, 73900
c07, 桃園市, 大溪區, 30058, 7843, 37901, 78285
c07, 桃園市, 平鎮區, 74739, 17335, 92074, 183560
c07, 桃園市, 復興區, 3740, 843, 4583, 9766
c07, 桃園市, 新屋區, 17090, 4471, 21561, 41461
c07, 桃園市, 桃園區, 135663, 36174, 171837, 359790
c07, 桃園市, 楊梅區, 54109, 12102, 66211, 137917
c07, 桃園市, 蘆竹區, 48141, 12964, 61105, 129252
c07, 桃園市, 觀音區, 20514, 5326, 25840, 55149
c07, 桃園市, 龍潭區, 42077, 9102, 51179, 101574
c07, 桃園市, 龜山區, 47936, 12769, 60705, 131702
c07, 澎湖縣, , 29508, 7117, 36625, 90405
c07, 澎湖縣, 七美鄉, 712, 180, 892, 3374
c07, 澎湖縣, 望安鄉, 1256, 302, 1558, 4628
c07, 澎湖縣, 湖西鄉, 3956, 930, 4886, 12741
c07, 澎湖縣, 白沙鄉, 2535, 688, 3223, 8625
c07, 澎湖縣, 西嶼鄉, 1641, 409, 2050, 7382
c07, 澎湖縣, 馬公市, 19408, 4608, 24016, 53655
c07, 臺中市, , 1013174, 234816, 1247990, 2295642
c07, 臺中市, 中區, 6132, 1541, 7673, 14696
c07, 臺中市, 北區, 53751, 12471, 66222, 124621
c07, 臺中市, 北屯區, 100833, 22423, 123256, 227720
c07, 臺中市, 南區, 48518, 11525, 60043, 103643
c07, 臺中市, 南屯區, 63052, 14504, 77556, 135448
c07, 臺中市, 后里區, 20022, 4396, 24418, 44962
c07, 臺中市, 和平區, 4505, 864, 5369, 9498
c07, 臺中市, 外埔區, 12116, 2667, 14783, 27059
c07, 臺中市, 大安區, 7288, 1691, 8979, 16520
c07, 臺中市, 大甲區, 27122, 6558, 33680, 63069
c07, 臺中市, 大肚區, 21090, 4776, 25866, 47457
c07, 臺中市, 大里區, 73521, 16988, 90509, 171769
c07, 臺中市, 大雅區, 33608, 7469, 41077, 77189
c07, 臺中市, 太平區, 66181, 14725, 80906, 157926
c07, 臺中市, 新社區, 8246, 1889, 10135, 20860
c07, 臺中市, 東勢區, 18958, 4311, 23269, 43181
c07, 臺中市, 東區, 28395, 6994, 35389, 64291
c07, 臺中市, 梧棲區, 20303, 4831, 25134, 47040
c07, 臺中市, 沙鹿區, 32234, 7425, 39659, 74207
c07, 臺中市, 清水區, 32206, 7100, 39306, 71528
c07, 臺中市, 潭子區, 39569, 8853, 48422, 89487
c07, 臺中市, 烏日區, 27379, 6443, 33822, 61705
c07, 臺中市, 石岡區, 5735, 1379, 7114, 12880
c07, 臺中市, 神岡區, 24223, 5774, 29997, 54565
c07, 臺中市, 西區, 41855, 10696, 52551, 95040
c07, 臺中市, 西屯區, 82825, 18412, 101237, 183814
c07, 臺中市, 豐原區, 61483, 15505, 76988, 136658
c07, 臺中市, 霧峰區, 25277, 5735, 31012, 55225
c07, 臺中市, 龍井區, 26747, 6871, 33618, 63584
c07, 臺北市, , 924026, 277072, 1201098, 2228430
c07, 臺北市, 中山區, 78649, 25050, 103699, 195148
c07, 臺北市, 中正區, 54089, 16359, 70448, 128292
c07, 臺北市, 信義區, 80160, 23245, 103405, 190444
c07, 臺北市, 內湖區, 101149, 28663, 129812, 236824
c07, 臺北市, 北投區, 85525, 25619, 111144, 213250
c07, 臺北市, 南港區, 43217, 12009, 55226, 101907
c07, 臺北市, 士林區, 96156, 31493, 127649, 241854
c07, 臺北市, 大同區, 42497, 14769, 57266, 107557
c07, 臺北市, 大安區, 104681, 32294, 136975, 252645
c07, 臺北市, 文山區, 101174, 26288, 127462, 227211
c07, 臺北市, 松山區, 72344, 21698, 94042, 169278
c07, 臺北市, 萬華區, 64385, 19585, 83970, 164020
c07, 臺南市, , 572230, 167275, 739505, 1594821
c07, 臺南市, 七股區, 6088, 1601, 7689, 19950
c07, 臺南市, 下營區, 6734, 1827, 8561, 20947
c07, 臺南市, 中西區, 24805, 8210, 33015, 65261
c07, 臺南市, 仁德區, 24241, 6852, 31093, 64632
c07, 臺南市, 佳里區, 19007, 4960, 23967, 50407
c07, 臺南市, 六甲區, 6274, 1934, 8208, 19144
c07, 臺南市, 北區, 41806, 12882, 54688, 110906
c07, 臺南市, 北門區, 2791, 714, 3505, 9925
c07, 臺南市, 南化區, 2581, 694, 3275, 7786
c07, 臺南市, 南區, 37899, 11973, 49872, 108650
c07, 臺南市, 善化區, 14134, 4332, 18466, 39950
c07, 臺南市, 大內區, 2868, 708, 3576, 8654
c07, 臺南市, 學甲區, 7444, 2145, 9589, 22567
c07, 臺南市, 安南區, 58644, 17005, 75649, 159654
c07, 臺南市, 安定區, 9675, 2801, 12476, 26104
c07, 臺南市, 安平區, 19987, 5922, 25909, 55379
c07, 臺南市, 官田區, 6127, 1935, 8062, 18675
c07, 臺南市, 將軍區, 5144, 1406, 6550, 17754
c07, 臺南市, 山上區, 1960, 542, 2502, 6511
c07, 臺南市, 左鎮區, 1315, 348, 1663, 4418
c07, 臺南市, 後壁區, 6384, 1789, 8173, 20841
c07, 臺南市, 新化區, 13968, 3880, 17848, 37296
c07, 臺南市, 新市區, 11296, 3511, 14807, 30386
c07, 臺南市, 新營區, 23334, 6243, 29577, 64949
c07, 臺南市, 東區, 59256, 18165, 77421, 153359
c07, 臺南市, 東山區, 4639, 1339, 5978, 18471
c07, 臺南市, 柳營區, 6416, 1700, 8116, 18804
c07, 臺南市, 楠西區, 2647, 696, 3343, 8528
c07, 臺南市, 歸仁區, 21131, 6313, 27444, 57387
c07, 臺南市, 永康區, 73031, 20165, 93196, 195001
c07, 臺南市, 玉井區, 4278, 1046, 5324, 12357
c07, 臺南市, 白河區, 7115, 2194, 9309, 24894
c07, 臺南市, 西港區, 7029, 1898, 8927, 21564
c07, 臺南市, 關廟區, 11016, 3138, 14154, 29913
c07, 臺南市, 鹽水區, 7197, 2115, 9312, 22121
c07, 臺南市, 麻豆區, 12768, 3962, 16730, 37963
c07, 臺南市, 龍崎區, 1201, 330, 1531, 3713
c07, 臺東縣, , 67881, 17418, 85299, 185996
c07, 臺東縣, 卑南鄉, 5493, 1478, 6971, 14976
c07, 臺東縣, 大武鄉, 1658, 485, 2143, 5266
c07, 臺東縣, 太麻里鄉, 3129, 898, 4027, 9666
c07, 臺東縣, 延平鄉, 1008, 311, 1319, 2930
c07, 臺東縣, 成功鎮, 4157, 1106, 5263, 12426
c07, 臺東縣, 東河鄉, 2149, 636, 2785, 7635
c07, 臺東縣, 池上鄉, 2353, 585, 2938, 7162
c07, 臺東縣, 海端鄉, 1151, 383, 1534, 3278
c07, 臺東縣, 綠島鄉, 1183, 276, 1459, 3579
c07, 臺東縣, 臺東市, 35634, 8420, 44054, 87803
c07, 臺東縣, 蘭嶼鄉, 1020, 384, 1404, 4181
c07, 臺東縣, 達仁鄉, 1240, 337, 1577, 3137
c07, 臺東縣, 金峰鄉, 1090, 318, 1408, 3028
c07, 臺東縣, 長濱鄉, 1686, 496, 2182, 6484
c07, 臺東縣, 關山鎮, 2816, 631, 3447, 7509
c07, 臺東縣, 鹿野鄉, 2114, 674, 2788, 6936
c07, 花蓮縣, , 108373, 25734, 134107, 278059
c07, 花蓮縣, 光復鄉, 4079, 1077, 5156, 11417
c07, 花蓮縣, 卓溪鄉, 1889, 515, 2404, 4947
c07, 花蓮縣, 吉安鄉, 29187, 6603, 35790, 72116
c07, 花蓮縣, 壽豐鄉, 6262, 1724, 7986, 15847
c07, 花蓮縣, 富里鄉, 2909, 736, 3645, 9065
c07, 花蓮縣, 新城鄉, 6963, 1575, 8538, 17029
c07, 花蓮縣, 玉里鎮, 6862, 1752, 8614, 20650
c07, 花蓮縣, 瑞穗鄉, 3616, 910, 4526, 10279
c07, 花蓮縣, 秀林鄉, 4415, 1109, 5524, 12562
c07, 花蓮縣, 花蓮市, 35174, 7825, 42999, 84807
c07, 花蓮縣, 萬榮鄉, 1872, 625, 2497, 5269
c07, 花蓮縣, 豐濱鄉, 1236, 386, 1622, 4395
c07, 花蓮縣, 鳳林鎮, 3909, 897, 4806, 9676
c07, 苗栗縣, , 198009, 47324, 245333, 461580
c07, 苗栗縣, 三灣鄉, 2464, 651, 3115, 5852
c07, 苗栗縣, 三義鄉, 6388, 1334, 7722, 13889
c07, 苗栗縣, 公館鄉, 12634, 3027, 15661, 28318
c07, 苗栗縣, 卓蘭鎮, 6482, 1521, 8003, 14772
c07, 苗栗縣, 南庄鄉, 3104, 893, 3997, 8784
c07, 苗栗縣, 大湖鄉, 5128, 1137, 6265, 12653
c07, 苗栗縣, 後龍鎮, 12288, 3270, 15558, 30948
c07, 苗栗縣, 泰安鄉, 2518, 616, 3134, 5180
c07, 苗栗縣, 獅潭鄉, 1552, 324, 1876, 3968
c07, 苗栗縣, 竹南鎮, 29221, 6996, 36217, 68528
c07, 苗栗縣, 苑裡鎮, 15998, 4451, 20449, 38890
c07, 苗栗縣, 苗栗市, 33815, 7069, 40884, 74249
c07, 苗栗縣, 西湖鄉, 2724, 617, 3341, 6382
c07, 苗栗縣, 通霄鎮, 11314, 3282, 14596, 29709
c07, 苗栗縣, 造橋鄉, 4744, 1156, 5900, 11027
c07, 苗栗縣, 銅鑼鄉, 6726, 1472, 8198, 15424
c07, 苗栗縣, 頭份市, 36143, 8496, 44639, 83617
c07, 苗栗縣, 頭屋鄉, 4766, 1012, 5778, 9390
c07, 連江縣, , 4843, 655, 5498, 11205
c07, 連江縣, 北竿鄉, 914, 141, 1055, 2125
c07, 連江縣, 南竿鄉, 2773, 367, 3140, 6461
c07, 連江縣, 東引鄉, 512, 52, 564, 1138
c07, 連江縣, 莒光鄉, 644, 95, 739, 1481
c07, 金門縣, , 35436, 6045, 41481, 122695
c07, 金門縣, 烈嶼鄉, 3546, 506, 4052, 11676
c07, 金門縣, 烏坵鄉, 138, 16, 154, 567
c07, 金門縣, 金城鎮, 10725, 1824, 12549, 37815
c07, 金門縣, 金寧鄉, 8151, 1507, 9658, 28162
c07, 金門縣, 金沙鎮, 5261, 868, 6129, 18560
c07, 金門縣, 金湖鎮, 7615, 1324, 8939, 25915
c07, 雲林縣, , 213508, 57394, 270902, 584480
c07, 雲林縣, 二崙鄉, 7403, 2281, 9684, 23367
c07, 雲林縣, 元長鄉, 6583, 1928, 8511, 22830
c07, 雲林縣, 北港鎮, 12837, 3548, 16385, 33958
c07, 雲林縣, 口湖鄉, 7648, 2080, 9728, 24193
c07, 雲林縣, 古坑鄉, 10321, 2757, 13078, 27477
c07, 雲林縣, 四湖鄉, 5552, 1552, 7104, 20983
c07, 雲林縣, 土庫鎮, 8902, 2454, 11356, 24412
c07, 雲林縣, 大埤鄉, 5988, 1651, 7639, 16509
c07, 雲林縣, 崙背鄉, 6925, 2106, 9031, 21050
c07, 雲林縣, 斗六市, 38874, 9361, 48235, 89761
c07, 雲林縣, 斗南鎮, 15804, 4072, 19876, 38138
c07, 雲林縣, 東勢鄉, 4542, 1181, 5723, 13239
c07, 雲林縣, 林內鄉, 6202, 1601, 7803, 15551
c07, 雲林縣, 水林鄉, 6599, 1794, 8393, 22508
c07, 雲林縣, 臺西鄉, 6679, 1728, 8407, 21125
c07, 雲林縣, 莿桐鄉, 9304, 2727, 12031, 24570
c07, 雲林縣, 虎尾鎮, 22521, 5890, 28411, 58167
c07, 雲林縣, 褒忠鄉, 4069, 1127, 5196, 11381
c07, 雲林縣, 西螺鎮, 14318, 3797, 18115, 38142
c07, 雲林縣, 麥寮鄉, 12437, 3759, 16196, 37119
c07, 高雄市, , 990802, 272337, 1263139, 2353342
c07, 高雄市, 三民區, 121925, 35486, 157411, 289519
c07, 高雄市, 仁武區, 31665, 8127, 39792, 73611
c07, 高雄市, 內門區, 4181, 1233, 5414, 13002
c07, 高雄市, 六龜區, 3692, 1075, 4767, 11501
c07, 高雄市, 前金區, 10022, 3181, 13203, 23928
c07, 高雄市, 前鎮區, 66683, 18986, 85669, 161797
c07, 高雄市, 大寮區, 40259, 10438, 50697, 97309
c07, 高雄市, 大樹區, 14634, 3834, 18468, 36772
c07, 高雄市, 大社區, 11644, 3867, 15511, 30046
c07, 高雄市, 小港區, 55974, 15327, 71301, 132733
c07, 高雄市, 岡山區, 37008, 9109, 46117, 81244
c07, 高雄市, 左營區, 73230, 18003, 91233, 161367
c07, 高雄市, 彌陀區, 7027, 1965, 8992, 16487
c07, 高雄市, 新興區, 18956, 5836, 24792, 44355
c07, 高雄市, 旗山區, 12737, 3373, 16110, 31996
c07, 高雄市, 旗津區, 8332, 2706, 11038, 24860
c07, 高雄市, 杉林區, 3301, 981, 4282, 10607
c07, 高雄市, 林園區, 23394, 6249, 29643, 59129
c07, 高雄市, 桃源區, 1339, 305, 1644, 3498
c07, 高雄市, 梓官區, 12760, 3460, 16220, 31025
c07, 高雄市, 楠梓區, 66374, 17502, 83876, 153132
c07, 高雄市, 橋頭區, 14112, 4123, 18235, 32565
c07, 高雄市, 永安區, 5315, 1565, 6880, 12001
c07, 高雄市, 湖內區, 10110, 2791, 12901, 25729
c07, 高雄市, 燕巢區, 10583, 2759, 13342, 26012
c07, 高雄市, 田寮區, 2119, 621, 2740, 6671
c07, 高雄市, 甲仙區, 1893, 444, 2337, 5417
c07, 高雄市, 美濃區, 13876, 3588, 17464, 35311
c07, 高雄市, 苓雅區, 62964, 18917, 81881, 146786
c07, 高雄市, 茂林區, 809, 166, 975, 1615
c07, 高雄市, 茄萣區, 9361, 3019, 12380, 26212
c07, 高雄市, 路竹區, 18361, 5165, 23526, 43850
c07, 高雄市, 那瑪夏區, 979, 254, 1233, 2424
c07, 高雄市, 阿蓮區, 9426, 2614, 12040, 24534
c07, 高雄市, 鳥松區, 16980, 4996, 21976, 39191
c07, 高雄市, 鳳山區, 130829, 33944, 164773, 300510
c07, 高雄市, 鹽埕區, 8437, 2797, 11234, 21617
c07, 高雄市, 鼓山區, 49511, 13531, 63042, 114979
c08, 全國, , 7599267, 2346316, 9945583, 19757067
c08, 南投縣, , 178821, 46683, 225504, 427089
c08, 南投縣, 中寮鄉, 5299, 1549, 6848, 13181
c08, 南投縣, 仁愛鄉, 4953, 1158, 6111, 12589
c08, 南投縣, 信義鄉, 5078, 1353, 6431, 13299
c08, 南投縣, 南投市, 37773, 9552, 47325, 84328
c08, 南投縣, 名間鄉, 14224, 3820, 18044, 33408
c08, 南投縣, 國姓鄉, 6621, 1861, 8482, 16597
c08, 南投縣, 埔里鎮, 29379, 7062, 36441, 68763
c08, 南投縣, 水里鄉, 6115, 1728, 7843, 15458
c08, 南投縣, 竹山鎮, 18263, 5289, 23552, 47034
c08, 南投縣, 草屯鎮, 35497, 9226, 44723, 82922
c08, 南投縣, 集集鎮, 4010, 1023, 5033, 9611
c08, 南投縣, 魚池鄉, 5418, 1488, 6906, 13958
c08, 南投縣, 鹿谷鄉, 6191, 1574, 7765, 15941
c08, 嘉義市, , 81506, 27853, 109359, 221553
c08, 嘉義市, 東區, 37194, 12843, 50037, 100647
c08, 嘉義市, 西區, 44312, 15010, 59322, 120906
c08, 嘉義縣, , 145827, 49345, 195172, 442775
c08, 嘉義縣, 中埔鄉, 12092, 4090, 16182, 39139
c08, 嘉義縣, 六腳鄉, 5473, 1859, 7332, 20821
c08, 嘉義縣, 大埔鄉, 1488, 448, 1936, 3999
c08, 嘉義縣, 大林鎮, 9111, 3032, 12143, 26922
c08, 嘉義縣, 太保市, 10962, 3836, 14798, 31568
c08, 嘉義縣, 布袋鎮, 7385, 2490, 9875, 23965
c08, 嘉義縣, 新港鄉, 9189, 3294, 12483, 27342
c08, 嘉義縣, 朴子市, 12009, 3835, 15844, 35191
c08, 嘉義縣, 東石鄉, 5381, 1864, 7245, 21915
c08, 嘉義縣, 梅山鄉, 6169, 2019, 8188, 17083
c08, 嘉義縣, 民雄鄉, 21538, 7626, 29164, 61209
c08, 嘉義縣, 水上鄉, 15249, 5407, 20656, 43857
c08, 嘉義縣, 溪口鄉, 4125, 1455, 5580, 13105
c08, 嘉義縣, 番路鄉, 3888, 1102, 4990, 10156
c08, 嘉義縣, 竹崎鄉, 10700, 3474, 14174, 31228
c08, 嘉義縣, 義竹鄉, 5431, 1796, 7227, 16647
c08, 嘉義縣, 阿里山鄉, 1539, 369, 1908, 4691
c08, 嘉義縣, 鹿草鄉, 4098, 1349, 5447, 13937
c08, 基隆市, , 118570, 33570, 152140, 320030
c08, 基隆市, 七堵區, 17242, 5289, 22531, 46256
c08, 基隆市, 中山區, 14924, 4550, 19474, 41856
c08, 基隆市, 中正區, 15275, 4267, 19542, 45545
c08, 基隆市, 仁愛區, 13573, 4225, 17798, 36738
c08, 基隆市, 信義區, 17958, 4332, 22290, 46014
c08, 基隆市, 安樂區, 26895, 7380, 34275, 70396
c08, 基隆市, 暖暖區, 12703, 3527, 16230, 33225
c08, 宜蘭縣, , 148910, 43259, 192169, 386089
c08, 宜蘭縣, 三星鄉, 6724, 2119, 8843, 19051
c08, 宜蘭縣, 五結鄉, 13195, 3768, 16963, 34892
c08, 宜蘭縣, 冬山鄉, 17407, 4801, 22208, 45405
c08, 宜蘭縣, 南澳鄉, 1987, 422, 2409, 4644
c08, 宜蘭縣, 員山鄉, 10219, 3058, 13277, 28131
c08, 宜蘭縣, 壯圍鄉, 8149, 2591, 10740, 21447
c08, 宜蘭縣, 大同鄉, 1581, 471, 2052, 4935
c08, 宜蘭縣, 宜蘭市, 32163, 8747, 40910, 79167
c08, 宜蘭縣, 礁溪鄉, 11552, 3510, 15062, 31084
c08, 宜蘭縣, 羅東鎮, 23361, 6884, 30245, 57686
c08, 宜蘭縣, 蘇澳鎮, 13182, 4065, 17247, 34512
c08, 宜蘭縣, 頭城鎮, 9390, 2823, 12213, 25135
c08, 屏東縣, , 245566, 79966, 325532, 711720
c08, 屏東縣, 三地門鄉, 2208, 644, 2852, 6373
c08, 屏東縣, 九如鄉, 6601, 2369, 8970, 19132
c08, 屏東縣, 佳冬鄉, 5317, 1854, 7171, 17063
c08, 屏東縣, 來義鄉, 2576, 642, 3218, 6257
c08, 屏東縣, 內埔鄉, 14890, 4816, 19706, 47558
c08, 屏東縣, 南州鄉, 3279, 1098, 4377, 9479
c08, 屏東縣, 屏東市, 63176, 19070, 82246, 170148
c08, 屏東縣, 崁頂鄉, 4227, 1400, 5627, 12270
c08, 屏東縣, 恆春鎮, 8345, 2490, 10835, 25661
c08, 屏東縣, 新園鄉, 10269, 3577, 13846, 30706
c08, 屏東縣, 新埤鄉, 2880, 990, 3870, 9033
c08, 屏東縣, 春日鄉, 739, 233, 972, 3923
c08, 屏東縣, 東港鎮, 13572, 4579, 18151, 39495
c08, 屏東縣, 枋寮鄉, 7292, 2451, 9743, 21394
c08, 屏東縣, 枋山鄉, 1616, 530, 2146, 4856
c08, 屏東縣, 林邊鄉, 5553, 1908, 7461, 15691
c08, 屏東縣, 泰武鄉, 1791, 580, 2371, 4344
c08, 屏東縣, 滿州鄉, 2123, 663, 2786, 7206
c08, 屏東縣, 潮州鎮, 16580, 5151, 21731, 46444
c08, 屏東縣, 牡丹鄉, 1305, 314, 1619, 4314
c08, 屏東縣, 獅子鄉, 1382, 314, 1696, 4230
c08, 屏東縣, 琉球鄉, 2962, 827, 3789, 10706
c08, 屏東縣, 瑪家鄉, 2346, 681, 3027, 5663
c08, 屏東縣, 竹田鄉, 5777, 2046, 7823, 15353
c08, 屏東縣, 萬丹鄉, 14920, 5311, 20231, 43478
c08, 屏東縣, 萬巒鄉, 5697, 2105, 7802, 17945
c08, 屏東縣, 車城鄉, 2023, 694, 2717, 7595
c08, 屏東縣, 里港鄉, 7701, 2799, 10500, 22128
c08, 屏東縣, 長治鄉, 9433, 3174, 12607, 26256
c08, 屏東縣, 霧臺鄉, 1106, 340, 1446, 2950
c08, 屏東縣, 高樹鄉, 6482, 2513, 8995, 21697
c08, 屏東縣, 鹽埔鄉, 7560, 2514, 10074, 22402
c08, 屏東縣, 麟洛鄉, 3838, 1289, 5127, 9970
c08, 彰化縣, , 427390, 128963, 556353, 1066994
c08, 彰化縣, 二林鎮, 15723, 4767, 20490, 42976
c08, 彰化縣, 二水鄉, 5356, 1784, 7140, 13339
c08, 彰化縣, 伸港鄉, 12385, 3334, 15719, 30407
c08, 彰化縣, 北斗鎮, 11209, 3312, 14521, 27593
c08, 彰化縣, 和美鎮, 30448, 9110, 39558, 75286
c08, 彰化縣, 員林市, 41186, 12364, 53550, 102028
c08, 彰化縣, 埔心鄉, 12457, 4053, 16510, 29642
c08, 彰化縣, 埔鹽鄉, 11850, 3486, 15336, 28026
c08, 彰化縣, 埤頭鄉, 9625, 2777, 12402, 25677
c08, 彰化縣, 大城鄉, 3820, 1117, 4937, 14713
c08, 彰化縣, 大村鄉, 13152, 3807, 16959, 31492
c08, 彰化縣, 彰化市, 81200, 25213, 106413, 190995
c08, 彰化縣, 永靖鄉, 12889, 3845, 16734, 31239
c08, 彰化縣, 溪州鄉, 8824, 2685, 11509, 25405
c08, 彰化縣, 溪湖鎮, 18816, 5155, 23971, 45147
c08, 彰化縣, 田中鎮, 14080, 4422, 18502, 35391
c08, 彰化縣, 田尾鄉, 9787, 2791, 12578, 23179
c08, 彰化縣, 社頭鄉, 14676, 4415, 19091, 36306
c08, 彰化縣, 福興鄉, 14835, 4407, 19242, 39745
c08, 彰化縣, 秀水鄉, 13411, 4221, 17632, 32394
c08, 彰化縣, 竹塘鄉, 4516, 1489, 6005, 12821
c08, 彰化縣, 線西鄉, 5907, 1723, 7630, 14065
c08, 彰化縣, 芬園鄉, 7792, 2316, 10108, 20408
c08, 彰化縣, 花壇鄉, 15558, 5026, 20584, 38924
c08, 彰化縣, 芳苑鄉, 9529, 2813, 12342, 29291
c08, 彰化縣, 鹿港鎮, 28359, 8531, 36890, 70505
c08, 新北市, , 1300337, 403443, 1703780, 3375513
c08, 新北市, 三峽區, 35036, 10500, 45536, 94291
c08, 新北市, 三芝區, 6742, 2135, 8877, 20119
c08, 新北市, 三重區, 122219, 42907, 165126, 329846
c08, 新北市, 中和區, 142856, 39619, 182475, 355978
c08, 新北市, 五股區, 26234, 8658, 34892, 72443
c08, 新北市, 八里區, 11981, 3941, 15922, 32970
c08, 新北市, 土城區, 76760, 24004, 100764, 200783
c08, 新北市, 坪林區, 1957, 618, 2575, 5891
c08, 新北市, 平溪區, 1333, 447, 1780, 4321
c08, 新北市, 新店區, 111123, 28106, 139229, 264053
c08, 新北市, 新莊區, 134468, 44611, 179079, 344981
c08, 新北市, 板橋區, 176926, 59047, 235973, 463411
c08, 新北市, 林口區, 34725, 10463, 45188, 86203
c08, 新北市, 樹林區, 57950, 18893, 76843, 152102
c08, 新北市, 永和區, 80629, 22072, 102701, 187798
c08, 新北市, 汐止區, 65487, 19406, 84893, 173831
c08, 新北市, 泰山區, 24980, 7590, 32570, 64252
c08, 新北市, 淡水區, 55441, 16540, 71981, 147272
c08, 新北市, 深坑區, 7992, 2416, 10408, 20624
c08, 新北市, 烏來區, 1982, 542, 2524, 5264
c08, 新北市, 瑞芳區, 11838, 3585, 15423, 35036
c08, 新北市, 石碇區, 2232, 829, 3061, 6861
c08, 新北市, 石門區, 3696, 1170, 4866, 10528
c08, 新北市, 萬里區, 6579, 2039, 8618, 19297
c08, 新北市, 蘆洲區, 60780, 20753, 81533, 167457
c08, 新北市, 貢寮區, 3171, 1167, 4338, 11279
c08, 新北市, 金山區, 6535, 2082, 8617, 18978
c08, 新北市, 雙溪區, 2599, 814, 3413, 7999
c08, 新北市, 鶯歌區, 26086, 8489, 34575, 71645
c08, 新竹市, , 141640, 43061, 184701, 351775
c08, 新竹市, 北區, 48668, 14935, 63603, 123122
c08, 新竹市, 東區, 66631, 20584, 87215, 163757
c08, 新竹市, 香山區, 26341, 7542, 33883, 64896
c08, 新竹縣, , 183636, 50494, 234130, 445051
c08, 新竹縣, 五峰鄉, 1217, 347, 1564, 3997
c08, 新竹縣, 北埔鄉, 3310, 931, 4241, 8180
c08, 新竹縣, 寶山鄉, 5520, 1553, 7073, 12973
c08, 新竹縣, 尖石鄉, 2272, 655, 2927, 7364
c08, 新竹縣, 峨眉鄉, 2134, 612, 2746, 5068
c08, 新竹縣, 新埔鎮, 11786, 3223, 15009, 28894
c08, 新竹縣, 新豐鄉, 18567, 5228, 23795, 45790
c08, 新竹縣, 橫山鄉, 4816, 1321, 6137, 11346
c08, 新竹縣, 湖口鄉, 26304, 7039, 33343, 63511
c08, 新竹縣, 竹北市, 58887, 16366, 75253, 137129
c08, 新竹縣, 竹東鎮, 31275, 8381, 39656, 78794
c08, 新竹縣, 芎林鄉, 7308, 2084, 9392, 17293
c08, 新竹縣, 關西鎮, 10240, 2754, 12994, 24712
c08, 桃園市, , 669790, 192616, 862406, 1801823
c08, 桃園市, 中壢區, 130138, 34651, 164789, 334402
c08, 桃園市, 八德區, 59933, 17095, 77028, 165065
c08, 桃園市, 大園區, 25568, 8256, 33824, 73900
c08, 桃園市, 大溪區, 28638, 8815, 37453, 78285
c08, 桃園市, 平鎮區, 71904, 18993, 90897, 183560
c08, 桃園市, 復興區, 3560, 968, 4528, 9766
c08, 桃園市, 新屋區, 16095, 5142, 21237, 41461
c08, 桃園市, 桃園區, 130494, 39403, 169897, 359790
c08, 桃園市, 楊梅區, 51985, 13752, 65737, 137917
c08, 桃園市, 蘆竹區, 46150, 14602, 60752, 129252
c08, 桃園市, 觀音區, 19477, 5998, 25475, 55149
c08, 桃園市, 龍潭區, 40185, 10399, 50584, 101574
c08, 桃園市, 龜山區, 45663, 14542, 60205, 131702
c08, 澎湖縣, , 28232, 7910, 36142, 90405
c08, 澎湖縣, 七美鄉, 667, 211, 878, 3374
c08, 澎湖縣, 望安鄉, 1192, 333, 1525, 4628
c08, 澎湖縣, 湖西鄉, 3825, 1035, 4860, 12741
c08, 澎湖縣, 白沙鄉, 2443, 756, 3199, 8625
c08, 澎湖縣, 西嶼鄉, 1618, 461, 2079, 7382
c08, 澎湖縣, 馬公市, 18487, 5114, 23601, 53655
c08, 臺中市, , 950822, 273963, 1224785, 2295642
c08, 臺中市, 中區, 5704, 1769, 7473, 14696
c08, 臺中市, 北區, 50598, 14519, 65117, 124621
c08, 臺中市, 北屯區, 95846, 25843, 121689, 227720
c08, 臺中市, 南區, 45430, 13472, 58902, 103643
c08, 臺中市, 南屯區, 59274, 16840, 76114, 135448
c08, 臺中市, 后里區, 18679, 5157, 23836, 44962
c08, 臺中市, 和平區, 4208, 1007, 5215, 9498
c08, 臺中市, 外埔區, 11290, 3099, 14389, 27059
c08, 臺中市, 大安區, 6763, 1921, 8684, 16520
c08, 臺中市, 大甲區, 25384, 7620, 33004, 63069
c08, 臺中市, 大肚區, 19777, 5502, 25279, 47457
c08, 臺中市, 大里區, 68915, 20147, 89062, 171769
c08, 臺中市, 大雅區, 32177, 8781, 40958, 77189
c08, 臺中市, 太平區, 61930, 17365, 79295, 157926
c08, 臺中市, 新社區, 7705, 2101, 9806, 20860
c08, 臺中市, 東勢區, 17561, 4978, 22539, 43181
c08, 臺中市, 東區, 26338, 8256, 34594, 64291
c08, 臺中市, 梧棲區, 18726, 5879, 24605, 47040
c08, 臺中市, 沙鹿區, 29978, 8985, 38963, 74207
c08, 臺中市, 清水區, 29604, 8760, 38364, 71528
c08, 臺中市, 潭子區, 37158, 10407, 47565, 89487
c08, 臺中市, 烏日區, 25559, 7417, 32976, 61705
c08, 臺中市, 石岡區, 5359, 1555, 6914, 12880
c08, 臺中市, 神岡區, 22607, 6854, 29461, 54565
c08, 臺中市, 西區, 39299, 12191, 51490, 95040
c08, 臺中市, 西屯區, 78086, 21557, 99643, 183814
c08, 臺中市, 豐原區, 58195, 17585, 75780, 136658
c08, 臺中市, 霧峰區, 23502, 6672, 30174, 55225
c08, 臺中市, 龍井區, 25170, 7724, 32894, 63584
c08, 臺北市, , 892660, 295984, 1188644, 2228430
c08, 臺北市, 中山區, 75659, 27107, 102766, 195148
c08, 臺北市, 中正區, 51892, 17351, 69243, 128292
c08, 臺北市, 信義區, 77960, 24430, 102390, 190444
c08, 臺北市, 內湖區, 97954, 30319, 128273, 236824
c08, 臺北市, 北投區, 82553, 27879, 110432, 213250
c08, 臺北市, 南港區, 41696, 13143, 54839, 101907
c08, 臺北市, 士林區, 92720, 33559, 126279, 241854
c08, 臺北市, 大同區, 40451, 16258, 56709, 107557
c08, 臺北市, 大安區, 101321, 33964, 135285, 252645
c08, 臺北市, 文山區, 98167, 28002, 126169, 227211
c08, 臺北市, 松山區, 70346, 22879, 93225, 169278
c08, 臺北市, 萬華區, 61941, 21093, 83034, 164020
c08, 臺南市, , 541984, 188192, 730176, 1594821
c08, 臺南市, 七股區, 5675, 1847, 7522, 19950
c08, 臺南市, 下營區, 6324, 2082, 8406, 20947
c08, 臺南市, 中西區, 23255, 9332, 32587, 65261
c08, 臺南市, 仁德區, 23085, 7505, 30590, 64632
c08, 臺南市, 佳里區, 17798, 5733, 23531, 50407
c08, 臺南市, 六甲區, 5861, 2209, 8070, 19144
c08, 臺南市, 北區, 39802, 14099, 53901, 110906
c08, 臺南市, 北門區, 2613, 829, 3442, 9925
c08, 臺南市, 南化區, 2452, 783, 3235, 7786
c08, 臺南市, 南區, 36014, 13298, 49312, 108650
c08, 臺南市, 善化區, 13391, 4901, 18292, 39950
c08, 臺南市, 大內區, 2664, 835, 3499, 8654
c08, 臺南市, 學甲區, 7007, 2508, 9515, 22567
c08, 臺南市, 安南區, 54864, 19800, 74664, 159654
c08, 臺南市, 安定區, 9082, 3227, 12309, 26104
c08, 臺南市, 安平區, 19061, 6603, 25664, 55379
c08, 臺南市, 官田區, 5689, 2207, 7896, 18675
c08, 臺南市, 將軍區, 4896, 1613, 6509, 17754
c08, 臺南市, 山上區, 1824, 635, 2459, 6511
c08, 臺南市, 左鎮區, 1219, 412, 1631, 4418
c08, 臺南市, 後壁區, 5961, 2055, 8016, 20841
c08, 臺南市, 新化區, 13258, 4349, 17607, 37296
c08, 臺南市, 新市區, 10793, 3857, 14650, 30386
c08, 臺南市, 新營區, 22398, 6951, 29349, 64949
c08, 臺南市, 東區, 56699, 19840, 76539, 153359
c08, 臺南市, 東山區, 4312, 1513, 5825, 18471
c08, 臺南市, 柳營區, 6048, 1944, 7992, 18804
c08, 臺南市, 楠西區, 2534, 745, 3279, 8528
c08, 臺南市, 歸仁區, 20119, 7113, 27232, 57387
c08, 臺南市, 永康區, 69493, 22722, 92215, 195001
c08, 臺南市, 玉井區, 4041, 1204, 5245, 12357
c08, 臺南市, 白河區, 6685, 2443, 9128, 24894
c08, 臺南市, 西港區, 6716, 2122, 8838, 21564
c08, 臺南市, 關廟區, 10370, 3637, 14007, 29913
c08, 臺南市, 鹽水區, 6743, 2449, 9192, 22121
c08, 臺南市, 麻豆區, 12101, 4413, 16514, 37963
c08, 臺南市, 龍崎區, 1137, 377, 1514, 3713
c08, 臺東縣, , 65521, 18824, 84345, 185996
c08, 臺東縣, 卑南鄉, 5255, 1631, 6886, 14976
c08, 臺東縣, 大武鄉, 1577, 542, 2119, 5266
c08, 臺東縣, 太麻里鄉, 2997, 971, 3968, 9666
c08, 臺東縣, 延平鄉, 974, 337, 1311, 2930
c08, 臺東縣, 成功鎮, 4010, 1193, 5203, 12426
c08, 臺東縣, 東河鄉, 2087, 663, 2750, 7635
c08, 臺東縣, 池上鄉, 2209, 673, 2882, 7162
c08, 臺東縣, 海端鄉, 1129, 391, 1520, 3278
c08, 臺東縣, 綠島鄉, 1147, 300, 1447, 3579
c08, 臺東縣, 臺東市, 34531, 9173, 43704, 87803
c08, 臺東縣, 蘭嶼鄉, 991, 401, 1392, 4181
c08, 臺東縣, 達仁鄉, 1291, 270, 1561, 3137
c08, 臺東縣, 金峰鄉, 1060, 340, 1400, 3028
c08, 臺東縣, 長濱鄉, 1590, 511, 2101, 6484
c08, 臺東縣, 關山鎮, 2662, 701, 3363, 7509
c08, 臺東縣, 鹿野鄉, 2011, 727, 2738, 6936
c08, 花蓮縣, , 104153, 28095, 132248, 278059
c08, 花蓮縣, 光復鄉, 3925, 1155, 5080, 11417
c08, 花蓮縣, 卓溪鄉, 1819, 555, 2374, 4947
c08, 花蓮縣, 吉安鄉, 28209, 7124, 35333, 72116
c08, 花蓮縣, 壽豐鄉, 5963, 1879, 7842, 15847
c08, 花蓮縣, 富里鄉, 2782, 822, 3604, 9065
c08, 花蓮縣, 新城鄉, 6668, 1798, 8466, 17029
c08, 花蓮縣, 玉里鎮, 6519, 1916, 8435, 20650
c08, 花蓮縣, 瑞穗鄉, 3429, 1006, 4435, 10279
c08, 花蓮縣, 秀林鄉, 4254, 1246, 5500, 12562
c08, 花蓮縣, 花蓮市, 33828, 8590, 42418, 84807
c08, 花蓮縣, 萬榮鄉, 1802, 667, 2469, 5269
c08, 花蓮縣, 豐濱鄉, 1172, 403, 1575, 4395
c08, 花蓮縣, 鳳林鎮, 3783, 934, 4717, 9676
c08, 苗栗縣, , 188547, 53465, 242012, 461580
c08, 苗栗縣, 三灣鄉, 2335, 716, 3051, 5852
c08, 苗栗縣, 三義鄉, 6123, 1538, 7661, 13889
c08, 苗栗縣, 公館鄉, 11979, 3364, 15343, 28318
c08, 苗栗縣, 卓蘭鎮, 6104, 1799, 7903, 14772
c08, 苗栗縣, 南庄鄉, 3033, 885, 3918, 8784
c08, 苗栗縣, 大湖鄉, 4829, 1347, 6176, 12653
c08, 苗栗縣, 後龍鎮, 11546, 3888, 15434, 30948
c08, 苗栗縣, 泰安鄉, 2425, 688, 3113, 5180
c08, 苗栗縣, 獅潭鄉, 1444, 370, 1814, 3968
c08, 苗栗縣, 竹南鎮, 28011, 7800, 35811, 68528
c08, 苗栗縣, 苑裡鎮, 14932, 5203, 20135, 38890
c08, 苗栗縣, 苗栗市, 32286, 8001, 40287, 74249
c08, 苗栗縣, 西湖鄉, 2586, 661, 3247, 6382
c08, 苗栗縣, 通霄鎮, 10444, 3914, 14358, 29709
c08, 苗栗縣, 造橋鄉, 4538, 1279, 5817, 11027
c08, 苗栗縣, 銅鑼鄉, 6444, 1608, 8052, 15424
c08, 苗栗縣, 頭份市, 34955, 9243, 44198, 83617
c08, 苗栗縣, 頭屋鄉, 4533, 1161, 5694, 9390
c08, 連江縣, , 4705, 769, 5474, 11205
c08, 連江縣, 北竿鄉, 903, 142, 1045, 2125
c08, 連江縣, 南竿鄉, 2708, 425, 3133, 6461
c08, 連江縣, 東引鄉, 484, 78, 562, 1138
c08, 連江縣, 莒光鄉, 610, 124, 734, 1481
c08, 金門縣, , 34139, 6816, 40955, 122695
c08, 金門縣, 烈嶼鄉, 3412, 556, 3968, 11676
c08, 金門縣, 烏坵鄉, 135, 20, 155, 567
c08, 金門縣, 金城鎮, 10346, 2034, 12380, 37815
c08, 金門縣, 金寧鄉, 7708, 1798, 9506, 28162
c08, 金門縣, 金沙鎮, 5095, 960, 6055, 18560
c08, 金門縣, 金湖鎮, 7443, 1448, 8891, 25915
c08, 雲林縣, , 201784, 65207, 266991, 584480
c08, 雲林縣, 二崙鄉, 7014, 2497, 9511, 23367
c08, 雲林縣, 元長鄉, 6174, 2194, 8368, 22830
c08, 雲林縣, 北港鎮, 12097, 4026, 16123, 33958
c08, 雲林縣, 口湖鄉, 7192, 2367, 9559, 24193
c08, 雲林縣, 古坑鄉, 9830, 3001, 12831, 27477
c08, 雲林縣, 四湖鄉, 5233, 1748, 6981, 20983
c08, 雲林縣, 土庫鎮, 8329, 2817, 11146, 24412
c08, 雲林縣, 大埤鄉, 5714, 1835, 7549, 16509
c08, 雲林縣, 崙背鄉, 6625, 2318, 8943, 21050
c08, 雲林縣, 斗六市, 37013, 10854, 47867, 89761
c08, 雲林縣, 斗南鎮, 14869, 4663, 19532, 38138
c08, 雲林縣, 東勢鄉, 4190, 1419, 5609, 13239
c08, 雲林縣, 林內鄉, 5852, 1805, 7657, 15551
c08, 雲林縣, 水林鄉, 6110, 2137, 8247, 22508
c08, 雲林縣, 臺西鄉, 6272, 1982, 8254, 21125
c08, 雲林縣, 莿桐鄉, 8735, 3012, 11747, 24570
c08, 雲林縣, 虎尾鎮, 21498, 6641, 28139, 58167
c08, 雲林縣, 褒忠鄉, 3862, 1292, 5154, 11381
c08, 雲林縣, 西螺鎮, 13352, 4447, 17799, 38142
c08, 雲林縣, 麥寮鄉, 11823, 4152, 15975, 37119
c08, 高雄市, , 944727, 307838, 1252565, 2353342
c08, 高雄市, 三民區, 116063, 39799, 155862, 289519
c08, 高雄市, 仁武區, 30136, 9368, 39504, 73611
c08, 高雄市, 內門區, 4045, 1307, 5352, 13002
c08, 高雄市, 六龜區, 3583, 1077, 4660, 11501
c08, 高雄市, 前金區, 9714, 3464, 13178, 23928
c08, 高雄市, 前鎮區, 63622, 21376, 84998, 161797
c08, 高雄市, 大寮區, 38152, 12176, 50328, 97309
c08, 高雄市, 大樹區, 13775, 4495, 18270, 36772
c08, 高雄市, 大社區, 11407, 4150, 15557, 30046
c08, 高雄市, 小港區, 53331, 17489, 70820, 132733
c08, 高雄市, 岡山區, 35021, 10410, 45431, 81244
c08, 高雄市, 左營區, 70034, 20435, 90469, 161367
c08, 高雄市, 彌陀區, 6672, 2280, 8952, 16487
c08, 高雄市, 新興區, 17858, 6745, 24603, 44355
c08, 高雄市, 旗山區, 11993, 3911, 15904, 31996
c08, 高雄市, 旗津區, 7980, 2930, 10910, 24860
c08, 高雄市, 杉林區, 3178, 1039, 4217, 10607
c08, 高雄市, 林園區, 21562, 7309, 28871, 59129
c08, 高雄市, 桃源區, 1284, 348, 1632, 3498
c08, 高雄市, 梓官區, 11955, 4135, 16090, 31025
c08, 高雄市, 楠梓區, 63689, 19693, 83382, 153132
c08, 高雄市, 橋頭區, 13387, 4597, 17984, 32565
c08, 高雄市, 永安區, 4954, 1826, 6780, 12001
c08, 高雄市, 湖內區, 9563, 3311, 12874, 25729
c08, 高雄市, 燕巢區, 9937, 3265, 13202, 26012
c08, 高雄市, 田寮區, 1969, 745, 2714, 6671
c08, 高雄市, 甲仙區, 1786, 515, 2301, 5417
c08, 高雄市, 美濃區, 13355, 3817, 17172, 35311
c08, 高雄市, 苓雅區, 60364, 21461, 81825, 146786
c08, 高雄市, 茂林區, 784, 183, 967, 1615
c08, 高雄市, 茄萣區, 8933, 3368, 12301, 26212
c08, 高雄市, 路竹區, 17563, 5709, 23272, 43850
c08, 高雄市, 那瑪夏區, 937, 275, 1212, 2424
c08, 高雄市, 阿蓮區, 8896, 3061, 11957, 24534
c08, 高雄市, 鳥松區, 16185, 5680, 21865, 39191
c08, 高雄市, 鳳山區, 125228, 38044, 163272, 300510
c08, 高雄市, 鹽埕區, 8031, 3161, 11192, 21617
c08, 高雄市, 鼓山區, 47801, 14884, 62685, 114979
c09, 全國, , 7791856, 2231425, 10023281, 19757067
c09, 南投縣, , 178955, 46704, 225659, 427089
c09, 南投縣, 中寮鄉, 5406, 1473, 6879, 13181
c09, 南投縣, 仁愛鄉, 4727, 1405, 6132, 12589
c09, 南投縣, 信義鄉, 4802, 1623, 6425, 13299
c09, 南投縣, 南投市, 38111, 9402, 47513, 84328
c09, 南投縣, 名間鄉, 14150, 3930, 18080, 33408
c09, 南投縣, 國姓鄉, 6677, 1824, 8501, 16597
c09, 南投縣, 埔里鎮, 29122, 7155, 36277, 68763
c09, 南投縣, 水里鄉, 6143, 1693, 7836, 15458
c09, 南投縣, 竹山鎮, 18660, 4928, 23588, 47034
c09, 南投縣, 草屯鎮, 35644, 9073, 44717, 82922
c09, 南投縣, 集集鎮, 3923, 1084, 5007, 9611
c09, 南投縣, 魚池鄉, 5432, 1494, 6926, 13958
c09, 南投縣, 鹿谷鄉, 6158, 1620, 7778, 15941
c09, 嘉義市, , 84825, 25741, 110566, 221553
c09, 嘉義市, 東區, 38093, 12423, 50516, 100647
c09, 嘉義市, 西區, 46732, 13318, 60050, 120906
c09, 嘉義縣, , 149984, 47427, 197411, 442775
c09, 嘉義縣, 中埔鄉, 12424, 3869, 16293, 39139
c09, 嘉義縣, 六腳鄉, 5627, 1792, 7419, 20821
c09, 嘉義縣, 大埔鄉, 1505, 446, 1951, 3999
c09, 嘉義縣, 大林鎮, 9524, 2915, 12439, 26922
c09, 嘉義縣, 太保市, 11386, 3585, 14971, 31568
c09, 嘉義縣, 布袋鎮, 7715, 2385, 10100, 23965
c09, 嘉義縣, 新港鄉, 9650, 3135, 12785, 27342
c09, 嘉義縣, 朴子市, 12495, 3747, 16242, 35191
c09, 嘉義縣, 東石鄉, 5321, 1829, 7150, 21915
c09, 嘉義縣, 梅山鄉, 6323, 1919, 8242, 17083
c09, 嘉義縣, 民雄鄉, 22263, 7199, 29462, 61209
c09, 嘉義縣, 水上鄉, 15484, 5157, 20641, 43857
c09, 嘉義縣, 溪口鄉, 4264, 1472, 5736, 13105
c09, 嘉義縣, 番路鄉, 3930, 1119, 5049, 10156
c09, 嘉義縣, 竹崎鄉, 10766, 3339, 14105, 31228
c09, 嘉義縣, 義竹鄉, 5589, 1748, 7337, 16647
c09, 嘉義縣, 阿里山鄉, 1540, 400, 1940, 4691
c09, 嘉義縣, 鹿草鄉, 4178, 1371, 5549, 13937
c09, 基隆市, , 119425, 33714, 153139, 320030
c09, 基隆市, 七堵區, 17292, 5343, 22635, 46256
c09, 基隆市, 中山區, 15210, 4487, 19697, 41856
c09, 基隆市, 中正區, 15237, 4438, 19675, 45545
c09, 基隆市, 仁愛區, 13796, 4161, 17957, 36738
c09, 基隆市, 信義區, 17997, 4548, 22545, 46014
c09, 基隆市, 安樂區, 27117, 7202, 34319, 70396
c09, 基隆市, 暖暖區, 12776, 3535, 16311, 33225
c09, 宜蘭縣, , 149047, 45210, 194257, 386089
c09, 宜蘭縣, 三星鄉, 6720, 2202, 8922, 19051
c09, 宜蘭縣, 五結鄉, 13187, 3935, 17122, 34892
c09, 宜蘭縣, 冬山鄉, 17337, 5095, 22432, 45405
c09, 宜蘭縣, 南澳鄉, 1938, 476, 2414, 4644
c09, 宜蘭縣, 員山鄉, 10227, 3218, 13445, 28131
c09, 宜蘭縣, 壯圍鄉, 8267, 2706, 10973, 21447
c09, 宜蘭縣, 大同鄉, 1552, 486, 2038, 4935
c09, 宜蘭縣, 宜蘭市, 32123, 9145, 41268, 79167
c09, 宜蘭縣, 礁溪鄉, 11637, 3652, 15289, 31084
c09, 宜蘭縣, 羅東鎮, 23633, 7130, 30763, 57686
c09, 宜蘭縣, 蘇澳鎮, 13047, 4165, 17212, 34512
c09, 宜蘭縣, 頭城鎮, 9379, 3000, 12379, 25135
c09, 屏東縣, , 248756, 79806, 328562, 711720
c09, 屏東縣, 三地門鄉, 2114, 776, 2890, 6373
c09, 屏東縣, 九如鄉, 6789, 2253, 9042, 19132
c09, 屏東縣, 佳冬鄉, 5642, 1673, 7315, 17063
c09, 屏東縣, 來義鄉, 2515, 662, 3177, 6257
c09, 屏東縣, 內埔鄉, 15290, 4786, 20076, 47558
c09, 屏東縣, 南州鄉, 3287, 1090, 4377, 9479
c09, 屏東縣, 屏東市, 64458, 18343, 82801, 170148
c09, 屏東縣, 崁頂鄉, 4264, 1436, 5700, 12270
c09, 屏東縣, 恆春鎮, 8238, 2668, 10906, 25661
c09, 屏東縣, 新園鄉, 10271, 3619, 13890, 30706
c09, 屏東縣, 新埤鄉, 2922, 1058, 3980, 9033
c09, 屏東縣, 春日鄉, 719, 261, 980, 3923
c09, 屏東縣, 東港鎮, 13808, 4617, 18425, 39495
c09, 屏東縣, 枋寮鄉, 7274, 2544, 9818, 21394
c09, 屏東縣, 枋山鄉, 1577, 577, 2154, 4856
c09, 屏東縣, 林邊鄉, 5595, 1994, 7589, 15691
c09, 屏東縣, 泰武鄉, 1771, 611, 2382, 4344
c09, 屏東縣, 滿州鄉, 2125, 650, 2775, 7206
c09, 屏東縣, 潮州鎮, 16646, 5232, 21878, 46444
c09, 屏東縣, 牡丹鄉, 1251, 370, 1621, 4314
c09, 屏東縣, 獅子鄉, 1346, 367, 1713, 4230
c09, 屏東縣, 琉球鄉, 2928, 867, 3795, 10706
c09, 屏東縣, 瑪家鄉, 2264, 780, 3044, 5663
c09, 屏東縣, 竹田鄉, 5870, 2003, 7873, 15353
c09, 屏東縣, 萬丹鄉, 15318, 5129, 20447, 43478
c09, 屏東縣, 萬巒鄉, 5851, 2028, 7879, 17945
c09, 屏東縣, 車城鄉, 1997, 728, 2725, 7595
c09, 屏東縣, 里港鄉, 7828, 2811, 10639, 22128
c09, 屏東縣, 長治鄉, 9495, 3250, 12745, 26256
c09, 屏東縣, 霧臺鄉, 1077, 381, 1458, 2950
c09, 屏東縣, 高樹鄉, 6606, 2450, 9056, 21697
c09, 屏東縣, 鹽埔鄉, 7682, 2584, 10266, 22402
c09, 屏東縣, 麟洛鄉, 3938, 1208, 5146, 9970
c09, 彰化縣, , 435289, 124114, 559403, 1066994
c09, 彰化縣, 二林鎮, 15738, 4574, 20312, 42976
c09, 彰化縣, 二水鄉, 5428, 1776, 7204, 13339
c09, 彰化縣, 伸港鄉, 12503, 3290, 15793, 30407
c09, 彰化縣, 北斗鎮, 11516, 3186, 14702, 27593
c09, 彰化縣, 和美鎮, 31150, 8679, 39829, 75286
c09, 彰化縣, 員林市, 41981, 11756, 53737, 102028
c09, 彰化縣, 埔心鄉, 12765, 3760, 16525, 29642
c09, 彰化縣, 埔鹽鄉, 12202, 3172, 15374, 28026
c09, 彰化縣, 埤頭鄉, 9747, 2585, 12332, 25677
c09, 彰化縣, 大城鄉, 3812, 1159, 4971, 14713
c09, 彰化縣, 大村鄉, 13263, 3714, 16977, 31492
c09, 彰化縣, 彰化市, 82918, 24013, 106931, 190995
c09, 彰化縣, 永靖鄉, 13073, 3831, 16904, 31239
c09, 彰化縣, 溪州鄉, 8840, 2710, 11550, 25405
c09, 彰化縣, 溪湖鎮, 18938, 5142, 24080, 45147
c09, 彰化縣, 田中鎮, 14161, 4397, 18558, 35391
c09, 彰化縣, 田尾鄉, 9767, 2733, 12500, 23179
c09, 彰化縣, 社頭鄉, 15033, 4210, 19243, 36306
c09, 彰化縣, 福興鄉, 14916, 4420, 19336, 39745
c09, 彰化縣, 秀水鄉, 13713, 4039, 17752, 32394
c09, 彰化縣, 竹塘鄉, 4563, 1487, 6050, 12821
c09, 彰化縣, 線西鄉, 5957, 1685, 7642, 14065
c09, 彰化縣, 芬園鄉, 7947, 2336, 10283, 20408
c09, 彰化縣, 花壇鄉, 16349, 4652, 21001, 38924
c09, 彰化縣, 芳苑鄉, 9721, 2873, 12594, 29291
c09, 彰化縣, 鹿港鎮, 29288, 7935, 37223, 70505
c09, 新北市, , 1338359, 382433, 1720792, 3375513
c09, 新北市, 三峽區, 35620, 10204, 45824, 94291
c09, 新北市, 三芝區, 6678, 2109, 8787, 20119
c09, 新北市, 三重區, 126943, 40687, 167630, 329846
c09, 新北市, 中和區, 146291, 38167, 184458, 355978
c09, 新北市, 五股區, 27203, 8114, 35317, 72443
c09, 新北市, 八里區, 12479, 3635, 16114, 32970
c09, 新北市, 土城區, 78444, 23052, 101496, 200783
c09, 新北市, 坪林區, 1953, 621, 2574, 5891
c09, 新北市, 平溪區, 1356, 440, 1796, 4321
c09, 新北市, 新店區, 112489, 27746, 140235, 264053
c09, 新北市, 新莊區, 139805, 40941, 180746, 344981
c09, 新北市, 板橋區, 183906, 55619, 239525, 463411
c09, 新北市, 林口區, 36130, 9352, 45482, 86203
c09, 新北市, 樹林區, 59598, 18134, 77732, 152102
c09, 新北市, 永和區, 82910, 20904, 103814, 187798
c09, 新北市, 汐止區, 66826, 18635, 85461, 173831
c09, 新北市, 泰山區, 25751, 7077, 32828, 64252
c09, 新北市, 淡水區, 56884, 15744, 72628, 147272
c09, 新北市, 深坑區, 8138, 2354, 10492, 20624
c09, 新北市, 烏來區, 1998, 531, 2529, 5264
c09, 新北市, 瑞芳區, 11889, 3499, 15388, 35036
c09, 新北市, 石碇區, 2295, 801, 3096, 6861
c09, 新北市, 石門區, 3763, 1130, 4893, 10528
c09, 新北市, 萬里區, 6706, 1960, 8666, 19297
c09, 新北市, 蘆洲區, 62795, 19292, 82087, 167457
c09, 新北市, 貢寮區, 3212, 1103, 4315, 11279
c09, 新北市, 金山區, 6592, 2052, 8644, 18978
c09, 新北市, 雙溪區, 2684, 763, 3447, 7999
c09, 新北市, 鶯歌區, 27021, 7767, 34788, 71645
c09, 新竹市, , 146486, 39257, 185743, 351775
c09, 新竹市, 北區, 50518, 13579, 64097, 123122
c09, 新竹市, 東區, 69052, 18559, 87611, 163757
c09, 新竹市, 香山區, 26916, 7119, 34035, 64896
c09, 新竹縣, , 187845, 47564, 235409, 445051
c09, 新竹縣, 五峰鄉, 1167, 381, 1548, 3997
c09, 新竹縣, 北埔鄉, 3408, 853, 4261, 8180
c09, 新竹縣, 寶山鄉, 5620, 1533, 7153, 12973
c09, 新竹縣, 尖石鄉, 2212, 713, 2925, 7364
c09, 新竹縣, 峨眉鄉, 2175, 595, 2770, 5068
c09, 新竹縣, 新埔鎮, 12046, 3055, 15101, 28894
c09, 新竹縣, 新豐鄉, 19113, 4910, 24023, 45790
c09, 新竹縣, 橫山鄉, 4871, 1288, 6159, 11346
c09, 新竹縣, 湖口鄉, 26766, 6632, 33398, 63511
c09, 新竹縣, 竹北市, 60847, 14949, 75796, 137129
c09, 新竹縣, 竹東鎮, 31963, 7885, 39848, 78794
c09, 新竹縣, 芎林鄉, 7422, 2022, 9444, 17293
c09, 新竹縣, 關西鎮, 10235, 2748, 12983, 24712
c09, 桃園市, , 688091, 178491, 866582, 1801823
c09, 桃園市, 中壢區, 133601, 31671, 165272, 334402
c09, 桃園市, 八德區, 61711, 15775, 77486, 165065
c09, 桃園市, 大園區, 26424, 7468, 33892, 73900
c09, 桃園市, 大溪區, 29096, 8537, 37633, 78285
c09, 桃園市, 平鎮區, 73505, 18054, 91559, 183560
c09, 桃園市, 復興區, 3523, 1008, 4531, 9766
c09, 桃園市, 新屋區, 16624, 4714, 21338, 41461
c09, 桃園市, 桃園區, 135146, 36154, 171300, 359790
c09, 桃園市, 楊梅區, 52981, 12652, 65633, 137917
c09, 桃園市, 蘆竹區, 47832, 13297, 61129, 129252
c09, 桃園市, 觀音區, 19925, 5698, 25623, 55149
c09, 桃園市, 龍潭區, 40992, 9904, 50896, 101574
c09, 桃園市, 龜山區, 46731, 13559, 60290, 131702
c09, 澎湖縣, , 28923, 7616, 36539, 90405
c09, 澎湖縣, 七美鄉, 660, 215, 875, 3374
c09, 澎湖縣, 望安鄉, 1146, 380, 1526, 4628
c09, 澎湖縣, 湖西鄉, 3895, 988, 4883, 12741
c09, 澎湖縣, 白沙鄉, 2487, 741, 3228, 8625
c09, 澎湖縣, 西嶼鄉, 1545, 522, 2067, 7382
c09, 澎湖縣, 馬公市, 19190, 4770, 23960, 53655
c09, 臺中市, , 979821, 256540, 1236361, 2295642
c09, 臺中市, 中區, 5791, 1823, 7614, 14696
c09, 臺中市, 北區, 52039, 13793, 65832, 124621
c09, 臺中市, 北屯區, 98529, 23765, 122294, 227720
c09, 臺中市, 南區, 46759, 12828, 59587, 103643
c09, 臺中市, 南屯區, 60752, 16391, 77143, 135448
c09, 臺中市, 后里區, 18978, 5164, 24142, 44962
c09, 臺中市, 和平區, 4219, 1051, 5270, 9498
c09, 臺中市, 外埔區, 11940, 2774, 14714, 27059
c09, 臺中市, 大安區, 6877, 1904, 8781, 16520
c09, 臺中市, 大甲區, 26358, 6823, 33181, 63069
c09, 臺中市, 大肚區, 20208, 5225, 25433, 47457
c09, 臺中市, 大里區, 70764, 18720, 89484, 171769
c09, 臺中市, 大雅區, 33234, 7930, 41164, 77189
c09, 臺中市, 太平區, 63860, 16284, 80144, 157926
c09, 臺中市, 新社區, 8051, 2049, 10100, 20860
c09, 臺中市, 東勢區, 18187, 4704, 22891, 43181
c09, 臺中市, 東區, 27322, 7695, 35017, 64291
c09, 臺中市, 梧棲區, 19604, 5267, 24871, 47040
c09, 臺中市, 沙鹿區, 31524, 7795, 39319, 74207
c09, 臺中市, 清水區, 30691, 8080, 38771, 71528
c09, 臺中市, 潭子區, 38184, 9737, 47921, 89487
c09, 臺中市, 烏日區, 26319, 7090, 33409, 61705
c09, 臺中市, 石岡區, 5462, 1576, 7038, 12880
c09, 臺中市, 神岡區, 23245, 6451, 29696, 54565
c09, 臺中市, 西區, 40385, 11765, 52150, 95040
c09, 臺中市, 西屯區, 79926, 20371, 100297, 183814
c09, 臺中市, 豐原區, 60188, 16041, 76229, 136658
c09, 臺中市, 霧峰區, 24158, 6486, 30644, 55225
c09, 臺中市, 龍井區, 26267, 6958, 33225, 63584
c09, 臺北市, , 922395, 279844, 1202239, 2228430
c09, 臺北市, 中山區, 78403, 25525, 103928, 195148
c09, 臺北市, 中正區, 54214, 16318, 70532, 128292
c09, 臺北市, 信義區, 80252, 22789, 103041, 190444
c09, 臺北市, 內湖區, 101210, 28795, 130005, 236824
c09, 臺北市, 北投區, 85399, 26239, 111638, 213250
c09, 臺北市, 南港區, 42721, 12523, 55244, 101907
c09, 臺北市, 士林區, 95594, 32145, 127739, 241854
c09, 臺北市, 大同區, 42181, 15060, 57241, 107557
c09, 臺北市, 大安區, 105524, 31885, 137409, 252645
c09, 臺北市, 文山區, 100344, 26928, 127272, 227211
c09, 臺北市, 松山區, 72672, 21614, 94286, 169278
c09, 臺北市, 萬華區, 63881, 20023, 83904, 164020
c09, 臺南市, , 560594, 178274, 738868, 1594821
c09, 臺南市, 七股區, 5754, 1890, 7644, 19950
c09, 臺南市, 下營區, 6443, 2029, 8472, 20947
c09, 臺南市, 中西區, 24374, 8814, 33188, 65261
c09, 臺南市, 仁德區, 24009, 7048, 31057, 64632
c09, 臺南市, 佳里區, 18292, 5510, 23802, 50407
c09, 臺南市, 六甲區, 6067, 2143, 8210, 19144
c09, 臺南市, 北區, 41607, 13080, 54687, 110906
c09, 臺南市, 北門區, 2663, 846, 3509, 9925
c09, 臺南市, 南化區, 2456, 808, 3264, 7786
c09, 臺南市, 南區, 37203, 12765, 49968, 108650
c09, 臺南市, 善化區, 13857, 4592, 18449, 39950
c09, 臺南市, 大內區, 2718, 875, 3593, 8654
c09, 臺南市, 學甲區, 7318, 2285, 9603, 22567
c09, 臺南市, 安南區, 57329, 18271, 75600, 159654
c09, 臺南市, 安定區, 9470, 2944, 12414, 26104
c09, 臺南市, 安平區, 19673, 6250, 25923, 55379
c09, 臺南市, 官田區, 5969, 2099, 8068, 18675
c09, 臺南市, 將軍區, 5072, 1558, 6630, 17754
c09, 臺南市, 山上區, 1873, 609, 2482, 6511
c09, 臺南市, 左鎮區, 1234, 439, 1673, 4418
c09, 臺南市, 後壁區, 6290, 1929, 8219, 20841
c09, 臺南市, 新化區, 13548, 4320, 17868, 37296
c09, 臺南市, 新市區, 11298, 3479, 14777, 30386
c09, 臺南市, 新營區, 22908, 6715, 29623, 64949
c09, 臺南市, 東區, 58738, 18683, 77421, 153359
c09, 臺南市, 東山區, 4446, 1557, 6003, 18471
c09, 臺南市, 柳營區, 6152, 1934, 8086, 18804
c09, 臺南市, 楠西區, 2572, 744, 3316, 8528
c09, 臺南市, 歸仁區, 20762, 6557, 27319, 57387
c09, 臺南市, 永康區, 71529, 21293, 92822, 195001
c09, 臺南市, 玉井區, 4104, 1186, 5290, 12357
c09, 臺南市, 白河區, 6981, 2370, 9351, 24894
c09, 臺南市, 西港區, 6712, 2132, 8844, 21564
c09, 臺南市, 關廟區, 10607, 3519, 14126, 29913
c09, 臺南市, 鹽水區, 6972, 2373, 9345, 22121
c09, 臺南市, 麻豆區, 12403, 4280, 16683, 37963
c09, 臺南市, 龍崎區, 1191, 348, 1539, 3713
c09, 臺東縣, , 65154, 19668, 84822, 185996
c09, 臺東縣, 卑南鄉, 5260, 1677, 6937, 14976
c09, 臺東縣, 大武鄉, 1563, 565, 2128, 5266
c09, 臺東縣, 太麻里鄉, 3009, 1008, 4017, 9666
c09, 臺東縣, 延平鄉, 979, 346, 1325, 2930
c09, 臺東縣, 成功鎮, 4034, 1197, 5231, 12426
c09, 臺東縣, 東河鄉, 2037, 739, 2776, 7635
c09, 臺東縣, 池上鄉, 2180, 719, 2899, 7162
c09, 臺東縣, 海端鄉, 1102, 424, 1526, 3278
c09, 臺東縣, 綠島鄉, 1139, 317, 1456, 3579
c09, 臺東縣, 臺東市, 34398, 9425, 43823, 87803
c09, 臺東縣, 蘭嶼鄉, 972, 443, 1415, 4181
c09, 臺東縣, 達仁鄉, 1191, 388, 1579, 3137
c09, 臺東縣, 金峰鄉, 1011, 396, 1407, 3028
c09, 臺東縣, 長濱鄉, 1578, 567, 2145, 6484
c09, 臺東縣, 關山鎮, 2664, 750, 3414, 7509
c09, 臺東縣, 鹿野鄉, 2037, 707, 2744, 6936
c09, 花蓮縣, , 104326, 28174, 132500, 278059
c09, 花蓮縣, 光復鄉, 3869, 1206, 5075, 11417
c09, 花蓮縣, 卓溪鄉, 1801, 540, 2341, 4947
c09, 花蓮縣, 吉安鄉, 28426, 6905, 35331, 72116
c09, 花蓮縣, 壽豐鄉, 5961, 1919, 7880, 15847
c09, 花蓮縣, 富里鄉, 2681, 890, 3571, 9065
c09, 花蓮縣, 新城鄉, 6577, 1897, 8474, 17029
c09, 花蓮縣, 玉里鎮, 6471, 1980, 8451, 20650
c09, 花蓮縣, 瑞穗鄉, 3418, 1003, 4421, 10279
c09, 花蓮縣, 秀林鄉, 4080, 1398, 5478, 12562
c09, 花蓮縣, 花蓮市, 34380, 8293, 42673, 84807
c09, 花蓮縣, 萬榮鄉, 1748, 734, 2482, 5269
c09, 花蓮縣, 豐濱鄉, 1129, 456, 1585, 4395
c09, 花蓮縣, 鳳林鎮, 3785, 953, 4738, 9676
c09, 苗栗縣, , 190918, 51594, 242512, 461580
c09, 苗栗縣, 三灣鄉, 2313, 742, 3055, 5852
c09, 苗栗縣, 三義鄉, 6215, 1468, 7683, 13889
c09, 苗栗縣, 公館鄉, 12057, 3320, 15377, 28318
c09, 苗栗縣, 卓蘭鎮, 6068, 1785, 7853, 14772
c09, 苗栗縣, 南庄鄉, 2985, 947, 3932, 8784
c09, 苗栗縣, 大湖鄉, 4826, 1340, 6166, 12653
c09, 苗栗縣, 後龍鎮, 11663, 3645, 15308, 30948
c09, 苗栗縣, 泰安鄉, 2394, 688, 3082, 5180
c09, 苗栗縣, 獅潭鄉, 1450, 374, 1824, 3968
c09, 苗栗縣, 竹南鎮, 28434, 7574, 36008, 68528
c09, 苗栗縣, 苑裡鎮, 15629, 4685, 20314, 38890
c09, 苗栗縣, 苗栗市, 33058, 7432, 40490, 74249
c09, 苗栗縣, 西湖鄉, 2572, 703, 3275, 6382
c09, 苗栗縣, 通霄鎮, 10767, 3578, 14345, 29709
c09, 苗栗縣, 造橋鄉, 4561, 1261, 5822, 11027
c09, 苗栗縣, 銅鑼鄉, 6390, 1673, 8063, 15424
c09, 苗栗縣, 頭份市, 35262, 8947, 44209, 83617
c09, 苗栗縣, 頭屋鄉, 4274, 1432, 5706, 9390
c09, 連江縣, , 4751, 736, 5487, 11205
c09, 連江縣, 北竿鄉, 888, 162, 1050, 2125
c09, 連江縣, 南竿鄉, 2746, 396, 3142, 6461
c09, 連江縣, 東引鄉, 497, 66, 563, 1138
c09, 連江縣, 莒光鄉, 620, 112, 732, 1481
c09, 金門縣, , 33982, 6656, 40638, 122695
c09, 金門縣, 烈嶼鄉, 3399, 572, 3971, 11676
c09, 金門縣, 烏坵鄉, 135, 19, 154, 567
c09, 金門縣, 金城鎮, 10357, 1954, 12311, 37815
c09, 金門縣, 金寧鄉, 7833, 1706, 9539, 28162
c09, 金門縣, 金沙鎮, 5110, 907, 6017, 18560
c09, 金門縣, 金湖鎮, 7148, 1498, 8646, 25915
c09, 雲林縣, , 205923, 61421, 267344, 584480
c09, 雲林縣, 二崙鄉, 7059, 2495, 9554, 23367
c09, 雲林縣, 元長鄉, 6209, 2193, 8402, 22830
c09, 雲林縣, 北港鎮, 12419, 3822, 16241, 33958
c09, 雲林縣, 口湖鄉, 7175, 2418, 9593, 24193
c09, 雲林縣, 古坑鄉, 9837, 2928, 12765, 27477
c09, 雲林縣, 四湖鄉, 5308, 1658, 6966, 20983
c09, 雲林縣, 土庫鎮, 8494, 2672, 11166, 24412
c09, 雲林縣, 大埤鄉, 5545, 2021, 7566, 16509
c09, 雲林縣, 崙背鄉, 6828, 2094, 8922, 21050
c09, 雲林縣, 斗六市, 37857, 9790, 47647, 89761
c09, 雲林縣, 斗南鎮, 15189, 4288, 19477, 38138
c09, 雲林縣, 東勢鄉, 4284, 1330, 5614, 13239
c09, 雲林縣, 林內鄉, 5885, 1800, 7685, 15551
c09, 雲林縣, 水林鄉, 6252, 2074, 8326, 22508
c09, 雲林縣, 臺西鄉, 6431, 1833, 8264, 21125
c09, 雲林縣, 莿桐鄉, 8760, 3042, 11802, 24570
c09, 雲林縣, 虎尾鎮, 22054, 6123, 28177, 58167
c09, 雲林縣, 褒忠鄉, 3848, 1298, 5146, 11381
c09, 雲林縣, 西螺鎮, 13877, 4030, 17907, 38142
c09, 雲林縣, 麥寮鄉, 12612, 3512, 16124, 37119
c09, 高雄市, , 968007, 290441, 1258448, 2353342
c09, 高雄市, 三民區, 120091, 37189, 157280, 289519
c09, 高雄市, 仁武區, 30858, 8796, 39654, 73611
c09, 高雄市, 內門區, 3998, 1359, 5357, 13002
c09, 高雄市, 六龜區, 3496, 1226, 4722, 11501
c09, 高雄市, 前金區, 9799, 3417, 13216, 23928
c09, 高雄市, 前鎮區, 65326, 20199, 85525, 161797
c09, 高雄市, 大寮區, 38925, 11430, 50355, 97309
c09, 高雄市, 大樹區, 13972, 4324, 18296, 36772
c09, 高雄市, 大社區, 11744, 3908, 15652, 30046
c09, 高雄市, 小港區, 55215, 15762, 70977, 132733
c09, 高雄市, 岡山區, 35934, 9783, 45717, 81244
c09, 高雄市, 左營區, 71184, 19573, 90757, 161367
c09, 高雄市, 彌陀區, 6401, 2587, 8988, 16487
c09, 高雄市, 新興區, 18404, 6488, 24892, 44355
c09, 高雄市, 旗山區, 12146, 3836, 15982, 31996
c09, 高雄市, 旗津區, 8132, 2910, 11042, 24860
c09, 高雄市, 杉林區, 3088, 1137, 4225, 10607
c09, 高雄市, 林園區, 22575, 6889, 29464, 59129
c09, 高雄市, 桃源區, 1239, 395, 1634, 3498
c09, 高雄市, 梓官區, 12179, 3914, 16093, 31025
c09, 高雄市, 楠梓區, 65274, 18600, 83874, 153132
c09, 高雄市, 橋頭區, 13650, 4323, 17973, 32565
c09, 高雄市, 永安區, 5146, 1654, 6800, 12001
c09, 高雄市, 湖內區, 9497, 3356, 12853, 25729
c09, 高雄市, 燕巢區, 10042, 3140, 13182, 26012
c09, 高雄市, 田寮區, 2021, 706, 2727, 6671
c09, 高雄市, 甲仙區, 1767, 518, 2285, 5417
c09, 高雄市, 美濃區, 13318, 3814, 17132, 35311
c09, 高雄市, 苓雅區, 62255, 19545, 81800, 146786
c09, 高雄市, 茂林區, 758, 213, 971, 1615
c09, 高雄市, 茄萣區, 9093, 3132, 12225, 26212
c09, 高雄市, 路竹區, 17739, 5509, 23248, 43850
c09, 高雄市, 那瑪夏區, 917, 303, 1220, 2424
c09, 高雄市, 阿蓮區, 9103, 2878, 11981, 24534
c09, 高雄市, 鳥松區, 16620, 5282, 21902, 39191
c09, 高雄市, 鳳山區, 129085, 35291, 164376, 300510
c09, 高雄市, 鹽埕區, 8309, 2943, 11252, 21617
c09, 高雄市, 鼓山區, 48707, 14112, 62819, 114979
c10, 全國, , 7658008, 2907429, 10565437, 19757067
c10, 南投縣, , 184051, 52700, 236751, 427089
c10, 南投縣, 中寮鄉, 5748, 1422, 7170, 13181
c10, 南投縣, 仁愛鄉, 5702, 1196, 6898, 12589
c10, 南投縣, 信義鄉, 6891, 1216, 8107, 13299
c10, 南投縣, 南投市, 37547, 11607, 49154, 84328
c10, 南投縣, 名間鄉, 14533, 4339, 18872, 33408
c10, 南投縣, 國姓鄉, 7089, 1754, 8843, 16597
c10, 南投縣, 埔里鎮, 29571, 8292, 37863, 68763
c10, 南投縣, 水里鄉, 6392, 1795, 8187, 15458
c10, 南投縣, 竹山鎮, 19254, 5389, 24643, 47034
c10, 南投縣, 草屯鎮, 35215, 11289, 46504, 82922
c10, 南投縣, 集集鎮, 4034, 1229, 5263, 9611
c10, 南投縣, 魚池鄉, 5603, 1534, 7137, 13958
c10, 南投縣, 鹿谷鄉, 6472, 1638, 8110, 15941
c10, 嘉義市, , 86583, 32815, 119398, 221553
c10, 嘉義市, 東區, 38806, 15349, 54155, 100647
c10, 嘉義市, 西區, 47777, 17466, 65243, 120906
c10, 嘉義縣, , 166655, 48809, 215464, 442775
c10, 嘉義縣, 中埔鄉, 13696, 4097, 17793, 39139
c10, 嘉義縣, 六腳鄉, 6755, 1735, 8490, 20821
c10, 嘉義縣, 大埔鄉, 1585, 501, 2086, 3999
c10, 嘉義縣, 大林鎮, 10329, 3045, 13374, 26922
c10, 嘉義縣, 太保市, 12266, 3958, 16224, 31568
c10, 嘉義縣, 布袋鎮, 8612, 2355, 10967, 23965
c10, 嘉義縣, 新港鄉, 10873, 3212, 14085, 27342
c10, 嘉義縣, 朴子市, 13420, 4113, 17533, 35191
c10, 嘉義縣, 東石鄉, 6940, 1640, 8580, 21915
c10, 嘉義縣, 梅山鄉, 6892, 1988, 8880, 17083
c10, 嘉義縣, 民雄鄉, 23825, 7586, 31411, 61209
c10, 嘉義縣, 水上鄉, 17400, 4998, 22398, 43857
c10, 嘉義縣, 溪口鄉, 4982, 1458, 6440, 13105
c10, 嘉義縣, 番路鄉, 4281, 1105, 5386, 10156
c10, 嘉義縣, 竹崎鄉, 12242, 3347, 15589, 31228
c10, 嘉義縣, 義竹鄉, 6137, 1837, 7974, 16647
c10, 嘉義縣, 阿里山鄉, 1767, 371, 2138, 4691
c10, 嘉義縣, 鹿草鄉, 4653, 1463, 6116, 13937
c10, 基隆市, , 116173, 44691, 160864, 320030
c10, 基隆市, 七堵區, 17231, 6505, 23736, 46256
c10, 基隆市, 中山區, 15249, 5791, 21040, 41856
c10, 基隆市, 中正區, 15445, 5335, 20780, 45545
c10, 基隆市, 仁愛區, 13703, 5184, 18887, 36738
c10, 基隆市, 信義區, 16896, 6719, 23615, 46014
c10, 基隆市, 安樂區, 25328, 10288, 35616, 70396
c10, 基隆市, 暖暖區, 12321, 4869, 17190, 33225
c10, 宜蘭縣, , 150234, 55064, 205298, 386089
c10, 宜蘭縣, 三星鄉, 6950, 2597, 9547, 19051
c10, 宜蘭縣, 五結鄉, 13075, 4826, 17901, 34892
c10, 宜蘭縣, 冬山鄉, 17229, 6321, 23550, 45405
c10, 宜蘭縣, 南澳鄉, 2366, 401, 2767, 4644
c10, 宜蘭縣, 員山鄉, 10506, 3689, 14195, 28131
c10, 宜蘭縣, 壯圍鄉, 8704, 3073, 11777, 21447
c10, 宜蘭縣, 大同鄉, 3001, 443, 3444, 4935
c10, 宜蘭縣, 宜蘭市, 30720, 12445, 43165, 79167
c10, 宜蘭縣, 礁溪鄉, 11795, 4186, 15981, 31084
c10, 宜蘭縣, 羅東鎮, 22790, 9020, 31810, 57686
c10, 宜蘭縣, 蘇澳鎮, 13507, 4747, 18254, 34512
c10, 宜蘭縣, 頭城鎮, 9591, 3316, 12907, 25135
c10, 屏東縣, , 270712, 85379, 356091, 711720
c10, 屏東縣, 三地門鄉, 2964, 846, 3810, 6373
c10, 屏東縣, 九如鄉, 7418, 2324, 9742, 19132
c10, 屏東縣, 佳冬鄉, 6104, 1799, 7903, 17063
c10, 屏東縣, 來義鄉, 2890, 701, 3591, 6257
c10, 屏東縣, 內埔鄉, 16703, 5211, 21914, 47558
c10, 屏東縣, 南州鄉, 3652, 1170, 4822, 9479
c10, 屏東縣, 屏東市, 64865, 22657, 87522, 170148
c10, 屏東縣, 崁頂鄉, 4526, 1549, 6075, 12270
c10, 屏東縣, 恆春鎮, 8603, 2827, 11430, 25661
c10, 屏東縣, 新園鄉, 11532, 3587, 15119, 30706
c10, 屏東縣, 新埤鄉, 3349, 899, 4248, 9033
c10, 屏東縣, 春日鄉, 1286, 407, 1693, 3923
c10, 屏東縣, 東港鎮, 15278, 4663, 19941, 39495
c10, 屏東縣, 枋寮鄉, 8342, 2303, 10645, 21394
c10, 屏東縣, 枋山鄉, 1831, 533, 2364, 4856
c10, 屏東縣, 林邊鄉, 6383, 1765, 8148, 15691
c10, 屏東縣, 泰武鄉, 2193, 574, 2767, 4344
c10, 屏東縣, 滿州鄉, 2250, 692, 2942, 7206
c10, 屏東縣, 潮州鎮, 17588, 5413, 23001, 46444
c10, 屏東縣, 牡丹鄉, 1327, 452, 1779, 4314
c10, 屏東縣, 獅子鄉, 2115, 446, 2561, 4230
c10, 屏東縣, 琉球鄉, 3577, 818, 4395, 10706
c10, 屏東縣, 瑪家鄉, 2897, 762, 3659, 5663
c10, 屏東縣, 竹田鄉, 6363, 1888, 8251, 15353
c10, 屏東縣, 萬丹鄉, 17040, 5202, 22242, 43478
c10, 屏東縣, 萬巒鄉, 6818, 1954, 8772, 17945
c10, 屏東縣, 車城鄉, 2257, 757, 3014, 7595
c10, 屏東縣, 里港鄉, 8492, 2892, 11384, 22128
c10, 屏東縣, 長治鄉, 10288, 3361, 13649, 26256
c10, 屏東縣, 霧臺鄉, 1694, 464, 2158, 2950
c10, 屏東縣, 高樹鄉, 7475, 2444, 9919, 21697
c10, 屏東縣, 鹽埔鄉, 8460, 2554, 11014, 22402
c10, 屏東縣, 麟洛鄉, 4152, 1465, 5617, 9970
c10, 彰化縣, , 447132, 139760, 586892, 1066994
c10, 彰化縣, 二林鎮, 16632, 4841, 21473, 42976
c10, 彰化縣, 二水鄉, 5976, 1711, 7687, 13339
c10, 彰化縣, 伸港鄉, 12387, 4001, 16388, 30407
c10, 彰化縣, 北斗鎮, 11911, 3461, 15372, 27593
c10, 彰化縣, 和美鎮, 30653, 10373, 41026, 75286
c10, 彰化縣, 員林市, 41969, 14102, 56071, 102028
c10, 彰化縣, 埔心鄉, 13270, 4073, 17343, 29642
c10, 彰化縣, 埔鹽鄉, 12636, 3341, 15977, 28026
c10, 彰化縣, 埤頭鄉, 9848, 2898, 12746, 25677
c10, 彰化縣, 大城鄉, 4311, 1049, 5360, 14713
c10, 彰化縣, 大村鄉, 13606, 4239, 17845, 31492
c10, 彰化縣, 彰化市, 82890, 29022, 111912, 190995
c10, 彰化縣, 永靖鄉, 13773, 4101, 17874, 31239
c10, 彰化縣, 溪州鄉, 9746, 2733, 12479, 25405
c10, 彰化縣, 溪湖鎮, 19037, 6014, 25051, 45147
c10, 彰化縣, 田中鎮, 15277, 4379, 19656, 35391
c10, 彰化縣, 田尾鄉, 10063, 2986, 13049, 23179
c10, 彰化縣, 社頭鄉, 15535, 4604, 20139, 36306
c10, 彰化縣, 福興鄉, 15883, 4653, 20536, 39745
c10, 彰化縣, 秀水鄉, 13956, 4445, 18401, 32394
c10, 彰化縣, 竹塘鄉, 5147, 1423, 6570, 12821
c10, 彰化縣, 線西鄉, 6150, 1832, 7982, 14065
c10, 彰化縣, 芬園鄉, 8360, 2461, 10821, 20408
c10, 彰化縣, 花壇鄉, 17218, 5170, 22388, 38924
c10, 彰化縣, 芳苑鄉, 10493, 2804, 13297, 29291
c10, 彰化縣, 鹿港鎮, 30405, 9044, 39449, 70505
c10, 新北市, , 1259036, 539138, 1798174, 3375513
c10, 新北市, 三峽區, 34546, 13393, 47939, 94291
c10, 新北市, 三芝區, 6808, 2518, 9326, 20119
c10, 新北市, 三重區, 121782, 54186, 175968, 329846
c10, 新北市, 中和區, 134952, 57145, 192097, 355978
c10, 新北市, 五股區, 26544, 10584, 37128, 72443
c10, 新北市, 八里區, 11996, 4660, 16656, 32970
c10, 新北市, 土城區, 74066, 32234, 106300, 200783
c10, 新北市, 坪林區, 2167, 638, 2805, 5891
c10, 新北市, 平溪區, 1582, 385, 1967, 4321
c10, 新北市, 新店區, 101656, 43236, 144892, 264053
c10, 新北市, 新莊區, 132191, 57351, 189542, 344981
c10, 新北市, 板橋區, 176457, 77394, 253851, 463411
c10, 新北市, 林口區, 31765, 14737, 46502, 86203
c10, 新北市, 樹林區, 56928, 23771, 80699, 152102
c10, 新北市, 永和區, 74085, 32814, 106899, 187798
c10, 新北市, 汐止區, 60784, 27746, 88530, 173831
c10, 新北市, 泰山區, 24580, 9739, 34319, 64252
c10, 新北市, 淡水區, 52094, 23054, 75148, 147272
c10, 新北市, 深坑區, 7628, 3300, 10928, 20624
c10, 新北市, 烏來區, 2118, 672, 2790, 5264
c10, 新北市, 瑞芳區, 12024, 4137, 16161, 35036
c10, 新北市, 石碇區, 2501, 819, 3320, 6861
c10, 新北市, 石門區, 3815, 1320, 5135, 10528
c10, 新北市, 萬里區, 6895, 2179, 9074, 19297
c10, 新北市, 蘆洲區, 59667, 26519, 86186, 167457
c10, 新北市, 貢寮區, 3533, 1148, 4681, 11279
c10, 新北市, 金山區, 6755, 2267, 9022, 18978
c10, 新北市, 雙溪區, 2822, 798, 3620, 7999
c10, 新北市, 鶯歌區, 26295, 10394, 36689, 71645
c10, 新竹市, , 135398, 58148, 193546, 351775
c10, 新竹市, 北區, 47686, 19422, 67108, 123122
c10, 新竹市, 東區, 61929, 29183, 91112, 163757
c10, 新竹市, 香山區, 25783, 9543, 35326, 64896
c10, 新竹縣, , 181680, 63339, 245019, 445051
c10, 新竹縣, 五峰鄉, 1774, 343, 2117, 3997
c10, 新竹縣, 北埔鄉, 3431, 1020, 4451, 8180
c10, 新竹縣, 寶山鄉, 5395, 1934, 7329, 12973
c10, 新竹縣, 尖石鄉, 3551, 573, 4124, 7364
c10, 新竹縣, 峨眉鄉, 2327, 594, 2921, 5068
c10, 新竹縣, 新埔鎮, 12060, 3598, 15658, 28894
c10, 新竹縣, 新豐鄉, 18858, 5985, 24843, 45790
c10, 新竹縣, 橫山鄉, 5052, 1310, 6362, 11346
c10, 新竹縣, 湖口鄉, 26323, 8274, 34597, 63511
c10, 新竹縣, 竹北市, 53786, 24075, 77861, 137129
c10, 新竹縣, 竹東鎮, 31110, 10315, 41425, 78794
c10, 新竹縣, 芎林鄉, 7391, 2410, 9801, 17293
c10, 新竹縣, 關西鎮, 10622, 2908, 13530, 24712
c10, 桃園市, , 655472, 245285, 900757, 1801823
c10, 桃園市, 中壢區, 123638, 46978, 170616, 334402
c10, 桃園市, 八德區, 58470, 21665, 80135, 165065
c10, 桃園市, 大園區, 26423, 9401, 35824, 73900
c10, 桃園市, 大溪區, 29684, 9924, 39608, 78285
c10, 桃園市, 平鎮區, 69987, 24798, 94785, 183560
c10, 桃園市, 復興區, 4593, 762, 5355, 9766
c10, 桃園市, 新屋區, 17013, 5147, 22160, 41461
c10, 桃園市, 桃園區, 123326, 53798, 177124, 359790
c10, 桃園市, 楊梅區, 51619, 16617, 68236, 137917
c10, 桃園市, 蘆竹區, 45943, 18188, 64131, 129252
c10, 桃園市, 觀音區, 20031, 6852, 26883, 55149
c10, 桃園市, 龍潭區, 40228, 12745, 52973, 101574
c10, 桃園市, 龜山區, 44517, 18410, 62927, 131702
c10, 澎湖縣, , 30169, 9187, 39356, 90405
c10, 澎湖縣, 七美鄉, 727, 259, 986, 3374
c10, 澎湖縣, 望安鄉, 1434, 396, 1830, 4628
c10, 澎湖縣, 湖西鄉, 4216, 1153, 5369, 12741
c10, 澎湖縣, 白沙鄉, 2808, 711, 3519, 8625
c10, 澎湖縣, 西嶼鄉, 1842, 514, 2356, 7382
c10, 澎湖縣, 馬公市, 19142, 6154, 25296, 53655
c10, 臺中市, , 937001, 342349, 1279350, 2295642
c10, 臺中市, 中區, 5864, 1992, 7856, 14696
c10, 臺中市, 北區, 48410, 19874, 68284, 124621
c10, 臺中市, 北屯區, 90632, 35861, 126493, 227720
c10, 臺中市, 南區, 43492, 17918, 61410, 103643
c10, 臺中市, 南屯區, 55403, 23888, 79291, 135448
c10, 臺中市, 后里區, 18408, 6384, 24792, 44962
c10, 臺中市, 和平區, 4628, 956, 5584, 9498
c10, 臺中市, 外埔區, 11728, 3418, 15146, 27059
c10, 臺中市, 大安區, 7095, 2058, 9153, 16520
c10, 臺中市, 大甲區, 26092, 8849, 34941, 63069
c10, 臺中市, 大肚區, 20041, 6262, 26303, 47457
c10, 臺中市, 大里區, 69234, 24075, 93309, 171769
c10, 臺中市, 大雅區, 31639, 11087, 42726, 77189
c10, 臺中市, 太平區, 62027, 21251, 83278, 157926
c10, 臺中市, 新社區, 8396, 2292, 10688, 20860
c10, 臺中市, 東勢區, 19191, 4955, 24146, 43181
c10, 臺中市, 東區, 26787, 9626, 36413, 64291
c10, 臺中市, 梧棲區, 18872, 6614, 25486, 47040
c10, 臺中市, 沙鹿區, 30000, 10467, 40467, 74207
c10, 臺中市, 清水區, 29922, 9817, 39739, 71528
c10, 臺中市, 潭子區, 37149, 12501, 49650, 89487
c10, 臺中市, 烏日區, 25322, 8987, 34309, 61705
c10, 臺中市, 石岡區, 5561, 1612, 7173, 12880
c10, 臺中市, 神岡區, 23506, 7436, 30942, 54565
c10, 臺中市, 西區, 37391, 16558, 53949, 95040
c10, 臺中市, 西屯區, 72436, 30741, 103177, 183814
c10, 臺中市, 豐原區, 58173, 20463, 78636, 136658
c10, 臺中市, 霧峰區, 24043, 7594, 31637, 55225
c10, 臺中市, 龍井區, 25559, 8813, 34372, 63584
c10, 臺北市, , 818887, 429583, 1248470, 2228430
c10, 臺北市, 中山區, 69454, 38233, 107687, 195148
c10, 臺北市, 中正區, 47831, 24913, 72744, 128292
c10, 臺北市, 信義區, 71262, 36103, 107365, 190444
c10, 臺北市, 內湖區, 86554, 47892, 134446, 236824
c10, 臺北市, 北投區, 76876, 39641, 116517, 213250
c10, 臺北市, 南港區, 38210, 19646, 57856, 101907
c10, 臺北市, 士林區, 88429, 45761, 134190, 241854
c10, 臺北市, 大同區, 39399, 20803, 60202, 107557
c10, 臺北市, 大安區, 91356, 50083, 141439, 252645
c10, 臺北市, 文山區, 86838, 44249, 131087, 227211
c10, 臺北市, 松山區, 63084, 33872, 96956, 169278
c10, 臺北市, 萬華區, 59594, 28387, 87981, 164020
c10, 臺南市, , 582450, 217619, 800069, 1594821
c10, 臺南市, 七股區, 7258, 2011, 9269, 19950
c10, 臺南市, 下營區, 7279, 2326, 9605, 20947
c10, 臺南市, 中西區, 24947, 10338, 35285, 65261
c10, 臺南市, 仁德區, 25012, 8676, 33688, 64632
c10, 臺南市, 佳里區, 19170, 6512, 25682, 50407
c10, 臺南市, 六甲區, 6261, 2575, 8836, 19144
c10, 臺南市, 北區, 41640, 17038, 58678, 110906
c10, 臺南市, 北門區, 3242, 836, 4078, 9925
c10, 臺南市, 南化區, 2782, 756, 3538, 7786
c10, 臺南市, 南區, 39517, 14859, 54376, 108650
c10, 臺南市, 善化區, 14283, 5725, 20008, 39950
c10, 臺南市, 大內區, 3200, 821, 4021, 8654
c10, 臺南市, 學甲區, 8001, 2459, 10460, 22567
c10, 臺南市, 安南區, 58866, 22149, 81015, 159654
c10, 臺南市, 安定區, 10120, 3357, 13477, 26104
c10, 臺南市, 安平區, 19053, 8273, 27326, 55379
c10, 臺南市, 官田區, 6624, 2280, 8904, 18675
c10, 臺南市, 將軍區, 5971, 2120, 8091, 17754
c10, 臺南市, 山上區, 2134, 646, 2780, 6511
c10, 臺南市, 左鎮區, 1615, 332, 1947, 4418
c10, 臺南市, 後壁區, 7155, 2165, 9320, 20841
c10, 臺南市, 新化區, 14534, 4924, 19458, 37296
c10, 臺南市, 新市區, 11632, 4216, 15848, 30386
c10, 臺南市, 新營區, 22927, 8754, 31681, 64949
c10, 臺南市, 東區, 57015, 24980, 81995, 153359
c10, 臺南市, 東山區, 5363, 1544, 6907, 18471
c10, 臺南市, 柳營區, 6828, 2082, 8910, 18804
c10, 臺南市, 楠西區, 2941, 761, 3702, 8528
c10, 臺南市, 歸仁區, 21719, 8119, 29838, 57387
c10, 臺南市, 永康區, 71049, 28157, 99206, 195001
c10, 臺南市, 玉井區, 4582, 1248, 5830, 12357
c10, 臺南市, 白河區, 7975, 2508, 10483, 24894
c10, 臺南市, 西港區, 7409, 2402, 9811, 21564
c10, 臺南市, 關廟區, 11757, 3807, 15564, 29913
c10, 臺南市, 鹽水區, 7778, 2522, 10300, 22121
c10, 臺南市, 麻豆區, 13400, 4974, 18374, 37963
c10, 臺南市, 龍崎區, 1411, 367, 1778, 3713
c10, 臺東縣, , 72221, 20213, 92434, 185996
c10, 臺東縣, 卑南鄉, 5747, 1643, 7390, 14976
c10, 臺東縣, 大武鄉, 2072, 520, 2592, 5266
c10, 臺東縣, 太麻里鄉, 4128, 932, 5060, 9666
c10, 臺東縣, 延平鄉, 1326, 307, 1633, 2930
c10, 臺東縣, 成功鎮, 4693, 1074, 5767, 12426
c10, 臺東縣, 東河鄉, 2506, 657, 3163, 7635
c10, 臺東縣, 池上鄉, 2357, 668, 3025, 7162
c10, 臺東縣, 海端鄉, 1382, 316, 1698, 3278
c10, 臺東縣, 綠島鄉, 1099, 443, 1542, 3579
c10, 臺東縣, 臺東市, 35766, 10460, 46226, 87803
c10, 臺東縣, 蘭嶼鄉, 1217, 399, 1616, 4181
c10, 臺東縣, 達仁鄉, 1446, 352, 1798, 3137
c10, 臺東縣, 金峰鄉, 1527, 397, 1924, 3028
c10, 臺東縣, 長濱鄉, 2037, 517, 2554, 6484
c10, 臺東縣, 關山鎮, 2728, 810, 3538, 7509
c10, 臺東縣, 鹿野鄉, 2190, 718, 2908, 6936
c10, 花蓮縣, , 110028, 30699, 140727, 278059
c10, 花蓮縣, 光復鄉, 4530, 1070, 5600, 11417
c10, 花蓮縣, 卓溪鄉, 2278, 496, 2774, 4947
c10, 花蓮縣, 吉安鄉, 28648, 8044, 36692, 72116
c10, 花蓮縣, 壽豐鄉, 6517, 1804, 8321, 15847
c10, 花蓮縣, 富里鄉, 2994, 765, 3759, 9065
c10, 花蓮縣, 新城鄉, 6871, 1975, 8846, 17029
c10, 花蓮縣, 玉里鎮, 7597, 1782, 9379, 20650
c10, 花蓮縣, 瑞穗鄉, 3987, 902, 4889, 10279
c10, 花蓮縣, 秀林鄉, 4845, 1325, 6170, 12562
c10, 花蓮縣, 花蓮市, 33819, 10516, 44335, 84807
c10, 花蓮縣, 萬榮鄉, 2376, 561, 2937, 5269
c10, 花蓮縣, 豐濱鄉, 1574, 461, 2035, 4395
c10, 花蓮縣, 鳳林鎮, 3992, 998, 4990, 9676
c10, 苗栗縣, , 193302, 58441, 251743, 461580
c10, 苗栗縣, 三灣鄉, 2498, 664, 3162, 5852
c10, 苗栗縣, 三義鄉, 6114, 1678, 7792, 13889
c10, 苗栗縣, 公館鄉, 12174, 3678, 15852, 28318
c10, 苗栗縣, 卓蘭鎮, 6376, 1908, 8284, 14772
c10, 苗栗縣, 南庄鄉, 3233, 869, 4102, 8784
c10, 苗栗縣, 大湖鄉, 5014, 1401, 6415, 12653
c10, 苗栗縣, 後龍鎮, 12396, 3728, 16124, 30948
c10, 苗栗縣, 泰安鄉, 2718, 619, 3337, 5180
c10, 苗栗縣, 獅潭鄉, 1565, 343, 1908, 3968
c10, 苗栗縣, 竹南鎮, 27788, 9368, 37156, 68528
c10, 苗栗縣, 苑裡鎮, 16565, 4721, 21286, 38890
c10, 苗栗縣, 苗栗市, 31728, 9817, 41545, 74249
c10, 苗栗縣, 西湖鄉, 2657, 718, 3375, 6382
c10, 苗栗縣, 通霄鎮, 12021, 3476, 15497, 29709
c10, 苗栗縣, 造橋鄉, 4728, 1328, 6056, 11027
c10, 苗栗縣, 銅鑼鄉, 6310, 1866, 8176, 15424
c10, 苗栗縣, 頭份市, 34848, 10973, 45821, 83617
c10, 苗栗縣, 頭屋鄉, 4569, 1286, 5855, 9390
c10, 連江縣, , 4341, 1249, 5590, 11205
c10, 連江縣, 北竿鄉, 832, 234, 1066, 2125
c10, 連江縣, 南竿鄉, 2485, 691, 3176, 6461
c10, 連江縣, 東引鄉, 432, 142, 574, 1138
c10, 連江縣, 莒光鄉, 592, 182, 774, 1481
c10, 金門縣, , 32991, 8977, 41968, 122695
c10, 金門縣, 烈嶼鄉, 3304, 748, 4052, 11676
c10, 金門縣, 烏坵鄉, 133, 24, 157, 567
c10, 金門縣, 金城鎮, 10065, 2610, 12675, 37815
c10, 金門縣, 金寧鄉, 7058, 2711, 9769, 28162
c10, 金門縣, 金沙鎮, 5217, 1043, 6260, 18560
c10, 金門縣, 金湖鎮, 7214, 1841, 9055, 25915
c10, 雲林縣, , 218210, 68279, 286489, 584480
c10, 雲林縣, 二崙鄉, 7998, 2436, 10434, 23367
c10, 雲林縣, 元長鄉, 7239, 2026, 9265, 22830
c10, 雲林縣, 北港鎮, 13375, 4138, 17513, 33958
c10, 雲林縣, 口湖鄉, 8462, 2123, 10585, 24193
c10, 雲林縣, 古坑鄉, 10581, 3109, 13690, 27477
c10, 雲林縣, 四湖鄉, 6015, 1765, 7780, 20983
c10, 雲林縣, 土庫鎮, 9140, 2883, 12023, 24412
c10, 雲林縣, 大埤鄉, 6372, 1732, 8104, 16509
c10, 雲林縣, 崙背鄉, 7445, 2190, 9635, 21050
c10, 雲林縣, 斗六市, 37033, 12751, 49784, 89761
c10, 雲林縣, 斗南鎮, 15902, 4987, 20889, 38138
c10, 雲林縣, 東勢鄉, 4780, 1364, 6144, 13239
c10, 雲林縣, 林內鄉, 6350, 1851, 8201, 15551
c10, 雲林縣, 水林鄉, 7175, 1872, 9047, 22508
c10, 雲林縣, 臺西鄉, 7062, 1953, 9015, 21125
c10, 雲林縣, 莿桐鄉, 9597, 3037, 12634, 24570
c10, 雲林縣, 虎尾鎮, 22353, 7509, 29862, 58167
c10, 雲林縣, 褒忠鄉, 4110, 1373, 5483, 11381
c10, 雲林縣, 西螺鎮, 14136, 5125, 19261, 38142
c10, 雲林縣, 麥寮鄉, 13085, 4055, 17140, 37119
c10, 高雄市, , 1005282, 355705, 1360987, 2353342
c10, 高雄市, 三民區, 121735, 48041, 169776, 289519
c10, 高雄市, 仁武區, 31863, 10599, 42462, 73611
c10, 高雄市, 內門區, 4951, 1203, 6154, 13002
c10, 高雄市, 六龜區, 4006, 1040, 5046, 11501
c10, 高雄市, 前金區, 10387, 3996, 14383, 23928
c10, 高雄市, 前鎮區, 68512, 24607, 93119, 161797
c10, 高雄市, 大寮區, 41344, 13324, 54668, 97309
c10, 高雄市, 大樹區, 15423, 4625, 20048, 36772
c10, 高雄市, 大社區, 12290, 4430, 16720, 30046
c10, 高雄市, 小港區, 56814, 19977, 76791, 132733
c10, 高雄市, 岡山區, 36943, 11832, 48775, 81244
c10, 高雄市, 左營區, 70061, 26437, 96498, 161367
c10, 高雄市, 彌陀區, 7695, 2184, 9879, 16487
c10, 高雄市, 新興區, 19319, 7718, 27037, 44355
c10, 高雄市, 旗山區, 13439, 3938, 17377, 31996
c10, 高雄市, 旗津區, 9528, 3540, 13068, 24860
c10, 高雄市, 杉林區, 3781, 920, 4701, 10607
c10, 高雄市, 林園區, 24254, 7968, 32222, 59129
c10, 高雄市, 桃源區, 1747, 348, 2095, 3498
c10, 高雄市, 梓官區, 14003, 4142, 18145, 31025
c10, 高雄市, 楠梓區, 65220, 23747, 88967, 153132
c10, 高雄市, 橋頭區, 14932, 4943, 19875, 32565
c10, 高雄市, 永安區, 5565, 1716, 7281, 12001
c10, 高雄市, 湖內區, 10650, 3395, 14045, 25729
c10, 高雄市, 燕巢區, 10820, 3489, 14309, 26012
c10, 高雄市, 田寮區, 2480, 596, 3076, 6671
c10, 高雄市, 甲仙區, 1987, 523, 2510, 5417
c10, 高雄市, 美濃區, 14658, 3656, 18314, 35311
c10, 高雄市, 苓雅區, 64689, 24674, 89363, 146786
c10, 高雄市, 茂林區, 865, 190, 1055, 1615
c10, 高雄市, 茄萣區, 10434, 3315, 13749, 26212
c10, 高雄市, 路竹區, 18878, 6137, 25015, 43850
c10, 高雄市, 那瑪夏區, 1424, 256, 1680, 2424
c10, 高雄市, 阿蓮區, 9799, 3220, 13019, 24534
c10, 高雄市, 鳥松區, 16980, 6317, 23297, 39191
c10, 高雄市, 鳳山區, 130402, 45870, 176272, 300510
c10, 高雄市, 鹽埕區, 8969, 3626, 12595, 21617
c10, 高雄市, 鼓山區, 48435, 19166, 67601, 114979
c11, 全國, , 7083379, 3419624, 10503003, 19757067
c11, 南投縣, , 165850, 68818, 234668, 427089
c11, 南投縣, 中寮鄉, 5044, 2026, 7070, 13181
c11, 南投縣, 仁愛鄉, 5232, 1742, 6974, 12589
c11, 南投縣, 信義鄉, 6243, 1740, 7983, 13299
c11, 南投縣, 南投市, 34407, 14480, 48887, 84328
c11, 南投縣, 名間鄉, 13206, 5577, 18783, 33408
c11, 南投縣, 國姓鄉, 6299, 2465, 8764, 16597
c11, 南投縣, 埔里鎮, 26111, 11041, 37152, 68763
c11, 南投縣, 水里鄉, 5746, 2368, 8114, 15458
c11, 南投縣, 竹山鎮, 17492, 7053, 24545, 47034
c11, 南投縣, 草屯鎮, 31801, 14221, 46022, 82922
c11, 南投縣, 集集鎮, 3586, 1648, 5234, 9611
c11, 南投縣, 魚池鄉, 4991, 2126, 7117, 13958
c11, 南投縣, 鹿谷鄉, 5692, 2331, 8023, 15941
c11, 嘉義市, , 80216, 38442, 118658, 221553
c11, 嘉義市, 東區, 36166, 17641, 53807, 100647
c11, 嘉義市, 西區, 44050, 20801, 64851, 120906
c11, 嘉義縣, , 148475, 64207, 212682, 442775
c11, 嘉義縣, 中埔鄉, 12230, 5403, 17633, 39139
c11, 嘉義縣, 六腳鄉, 5883, 2405, 8288, 20821
c11, 嘉義縣, 大埔鄉, 1457, 613, 2070, 3999
c11, 嘉義縣, 大林鎮, 9104, 4064, 13168, 26922
c11, 嘉義縣, 太保市, 11095, 5051, 16146, 31568
c11, 嘉義縣, 布袋鎮, 7832, 3134, 10966, 23965
c11, 嘉義縣, 新港鄉, 9438, 4225, 13663, 27342
c11, 嘉義縣, 朴子市, 11894, 5250, 17144, 35191
c11, 嘉義縣, 東石鄉, 6163, 2341, 8504, 21915
c11, 嘉義縣, 梅山鄉, 6165, 2683, 8848, 17083
c11, 嘉義縣, 民雄鄉, 21384, 9645, 31029, 61209
c11, 嘉義縣, 水上鄉, 15297, 6915, 22212, 43857
c11, 嘉義縣, 溪口鄉, 4582, 1735, 6317, 13105
c11, 嘉義縣, 番路鄉, 3791, 1470, 5261, 10156
c11, 嘉義縣, 竹崎鄉, 11132, 4513, 15645, 31228
c11, 嘉義縣, 義竹鄉, 5456, 2316, 7772, 16647
c11, 嘉義縣, 阿里山鄉, 1511, 595, 2106, 4691
c11, 嘉義縣, 鹿草鄉, 4061, 1849, 5910, 13937
c11, 基隆市, , 106801, 52811, 159612, 320030
c11, 基隆市, 七堵區, 15867, 7761, 23628, 46256
c11, 基隆市, 中山區, 13795, 6824, 20619, 41856
c11, 基隆市, 中正區, 13964, 6670, 20634, 45545
c11, 基隆市, 仁愛區, 12588, 6081, 18669, 36738
c11, 基隆市, 信義區, 15769, 7829, 23598, 46014
c11, 基隆市, 安樂區, 23424, 11849, 35273, 70396
c11, 基隆市, 暖暖區, 11394, 5797, 17191, 33225
c11, 宜蘭縣, , 136422, 67663, 204085, 386089
c11, 宜蘭縣, 三星鄉, 6484, 3005, 9489, 19051
c11, 宜蘭縣, 五結鄉, 11876, 5992, 17868, 34892
c11, 宜蘭縣, 冬山鄉, 15402, 7791, 23193, 45405
c11, 宜蘭縣, 南澳鄉, 2199, 551, 2750, 4644
c11, 宜蘭縣, 員山鄉, 9477, 4864, 14341, 28131
c11, 宜蘭縣, 壯圍鄉, 7858, 3818, 11676, 21447
c11, 宜蘭縣, 大同鄉, 2772, 647, 3419, 4935
c11, 宜蘭縣, 宜蘭市, 28367, 14687, 43054, 79167
c11, 宜蘭縣, 礁溪鄉, 10409, 5498, 15907, 31084
c11, 宜蘭縣, 羅東鎮, 20888, 10793, 31681, 57686
c11, 宜蘭縣, 蘇澳鎮, 12078, 5794, 17872, 34512
c11, 宜蘭縣, 頭城鎮, 8612, 4223, 12835, 25135
c11, 屏東縣, , 244464, 110273, 354737, 711720
c11, 屏東縣, 三地門鄉, 2700, 1086, 3786, 6373
c11, 屏東縣, 九如鄉, 6634, 3021, 9655, 19132
c11, 屏東縣, 佳冬鄉, 5306, 2532, 7838, 17063
c11, 屏東縣, 來義鄉, 2652, 928, 3580, 6257
c11, 屏東縣, 內埔鄉, 15255, 6597, 21852, 47558
c11, 屏東縣, 南州鄉, 3161, 1531, 4692, 9479
c11, 屏東縣, 屏東市, 59826, 27326, 87152, 170148
c11, 屏東縣, 崁頂鄉, 4115, 1955, 6070, 12270
c11, 屏東縣, 恆春鎮, 7601, 3748, 11349, 25661
c11, 屏東縣, 新園鄉, 10302, 4796, 15098, 30706
c11, 屏東縣, 新埤鄉, 2876, 1332, 4208, 9033
c11, 屏東縣, 春日鄉, 1141, 552, 1693, 3923
c11, 屏東縣, 東港鎮, 13670, 6084, 19754, 39495
c11, 屏東縣, 枋寮鄉, 7401, 3213, 10614, 21394
c11, 屏東縣, 枋山鄉, 1618, 740, 2358, 4856
c11, 屏東縣, 林邊鄉, 5745, 2409, 8154, 15691
c11, 屏東縣, 泰武鄉, 1967, 782, 2749, 4344
c11, 屏東縣, 滿州鄉, 1923, 979, 2902, 7206
c11, 屏東縣, 潮州鎮, 16355, 6934, 23289, 46444
c11, 屏東縣, 牡丹鄉, 1211, 558, 1769, 4314
c11, 屏東縣, 獅子鄉, 1938, 615, 2553, 4230
c11, 屏東縣, 琉球鄉, 3222, 1192, 4414, 10706
c11, 屏東縣, 瑪家鄉, 2625, 924, 3549, 5663
c11, 屏東縣, 竹田鄉, 5613, 2696, 8309, 15353
c11, 屏東縣, 萬丹鄉, 15225, 6826, 22051, 43478
c11, 屏東縣, 萬巒鄉, 6179, 2566, 8745, 17945
c11, 屏東縣, 車城鄉, 1901, 1063, 2964, 7595
c11, 屏東縣, 里港鄉, 7569, 3695, 11264, 22128
c11, 屏東縣, 長治鄉, 9356, 4260, 13616, 26256
c11, 屏東縣, 霧臺鄉, 1628, 548, 2176, 2950
c11, 屏東縣, 高樹鄉, 6623, 3300, 9923, 21697
c11, 屏東縣, 鹽埔鄉, 7456, 3572, 11028, 22402
c11, 屏東縣, 麟洛鄉, 3670, 1913, 5583, 9970
c11, 彰化縣, , 404865, 177099, 581964, 1066994
c11, 彰化縣, 二林鎮, 15018, 6114, 21132, 42976
c11, 彰化縣, 二水鄉, 5450, 2119, 7569, 13339
c11, 彰化縣, 伸港鄉, 11059, 5132, 16191, 30407
c11, 彰化縣, 北斗鎮, 10868, 4308, 15176, 27593
c11, 彰化縣, 和美鎮, 28171, 12933, 41104, 75286
c11, 彰化縣, 員林市, 38409, 17556, 55965, 102028
c11, 彰化縣, 埔心鄉, 11880, 5347, 17227, 29642
c11, 彰化縣, 埔鹽鄉, 11384, 4379, 15763, 28026
c11, 彰化縣, 埤頭鄉, 8843, 4208, 13051, 25677
c11, 彰化縣, 大城鄉, 3724, 1500, 5224, 14713
c11, 彰化縣, 大村鄉, 12091, 5404, 17495, 31492
c11, 彰化縣, 彰化市, 76438, 34580, 111018, 190995
c11, 彰化縣, 永靖鄉, 12176, 5389, 17565, 31239
c11, 彰化縣, 溪州鄉, 8627, 3673, 12300, 25405
c11, 彰化縣, 溪湖鎮, 17125, 7662, 24787, 45147
c11, 彰化縣, 田中鎮, 13537, 5892, 19429, 35391
c11, 彰化縣, 田尾鄉, 8969, 3949, 12918, 23179
c11, 彰化縣, 社頭鄉, 14152, 5816, 19968, 36306
c11, 彰化縣, 福興鄉, 14430, 5939, 20369, 39745
c11, 彰化縣, 秀水鄉, 12650, 5582, 18232, 32394
c11, 彰化縣, 竹塘鄉, 4362, 2048, 6410, 12821
c11, 彰化縣, 線西鄉, 5502, 2363, 7865, 14065
c11, 彰化縣, 芬園鄉, 7522, 3102, 10624, 20408
c11, 彰化縣, 花壇鄉, 15812, 6438, 22250, 38924
c11, 彰化縣, 芳苑鄉, 9516, 3827, 13343, 29291
c11, 彰化縣, 鹿港鎮, 27150, 11839, 38989, 70505
c11, 新北市, , 1174782, 617886, 1792668, 3375513
c11, 新北市, 三峽區, 31817, 16221, 48038, 94291
c11, 新北市, 三芝區, 6012, 3223, 9235, 20119
c11, 新北市, 三重區, 112720, 62661, 175381, 329846
c11, 新北市, 中和區, 128026, 63253, 191279, 355978
c11, 新北市, 五股區, 24500, 12684, 37184, 72443
c11, 新北市, 八里區, 11117, 5506, 16623, 32970
c11, 新北市, 土城區, 68330, 37301, 105631, 200783
c11, 新北市, 坪林區, 1929, 851, 2780, 5891
c11, 新北市, 平溪區, 1375, 567, 1942, 4321
c11, 新北市, 新店區, 96556, 47821, 144377, 264053
c11, 新北市, 新莊區, 122586, 65677, 188263, 344981
c11, 新北市, 板橋區, 165739, 87319, 253058, 463411
c11, 新北市, 林口區, 29960, 16503, 46463, 86203
c11, 新北市, 樹林區, 52556, 28151, 80707, 152102
c11, 新北市, 永和區, 70523, 36568, 107091, 187798
c11, 新北市, 汐止區, 56900, 31479, 88379, 173831
c11, 新北市, 泰山區, 22738, 11509, 34247, 64252
c11, 新北市, 淡水區, 49398, 25857, 75255, 147272
c11, 新北市, 深坑區, 7111, 3814, 10925, 20624
c11, 新北市, 烏來區, 2001, 807, 2808, 5264
c11, 新北市, 瑞芳區, 10789, 5332, 16121, 35036
c11, 新北市, 石碇區, 2196, 1094, 3290, 6861
c11, 新北市, 石門區, 3393, 1701, 5094, 10528
c11, 新北市, 萬里區, 6308, 2705, 9013, 19297
c11, 新北市, 蘆洲區, 54605, 31092, 85697, 167457
c11, 新北市, 貢寮區, 3111, 1518, 4629, 11279
c11, 新北市, 金山區, 6061, 2900, 8961, 18978
c11, 新北市, 雙溪區, 2499, 1075, 3574, 7999
c11, 新北市, 鶯歌區, 23926, 12697, 36623, 71645
c11, 新竹市, , 127376, 65250, 192626, 351775
c11, 新竹市, 北區, 44836, 21959, 66795, 123122
c11, 新竹市, 東區, 58811, 31895, 90706, 163757
c11, 新竹市, 香山區, 23729, 11396, 35125, 64896
c11, 新竹縣, , 168550, 75167, 243717, 445051
c11, 新竹縣, 五峰鄉, 1584, 532, 2116, 3997
c11, 新竹縣, 北埔鄉, 3132, 1308, 4440, 8180
c11, 新竹縣, 寶山鄉, 4929, 2292, 7221, 12973
c11, 新竹縣, 尖石鄉, 3206, 938, 4144, 7364
c11, 新竹縣, 峨眉鄉, 2098, 769, 2867, 5068
c11, 新竹縣, 新埔鎮, 10885, 4581, 15466, 28894
c11, 新竹縣, 新豐鄉, 17326, 7381, 24707, 45790
c11, 新竹縣, 橫山鄉, 4589, 1707, 6296, 11346
c11, 新竹縣, 湖口鄉, 24223, 10192, 34415, 63511
c11, 新竹縣, 竹北市, 51290, 26410, 77700, 137129
c11, 新竹縣, 竹東鎮, 28870, 12312, 41182, 78794
c11, 新竹縣, 芎林鄉, 6800, 2943, 9743, 17293
c11, 新竹縣, 關西鎮, 9618, 3802, 13420, 24712
c11, 桃園市, , 605777, 291473, 897250, 1801823
c11, 桃園市, 中壢區, 115927, 54953, 170880, 334402
c11, 桃園市, 八德區, 53759, 25976, 79735, 165065
c11, 桃園市, 大園區, 24004, 11708, 35712, 73900
c11, 桃園市, 大溪區, 26867, 12405, 39272, 78285
c11, 桃園市, 平鎮區, 65194, 29119, 94313, 183560
c11, 桃園市, 復興區, 4141, 1209, 5350, 9766
c11, 桃園市, 新屋區, 15252, 6774, 22026, 41461
c11, 桃園市, 桃園區, 114447, 61960, 176407, 359790
c11, 桃園市, 楊梅區, 47427, 20443, 67870, 137917
c11, 桃園市, 蘆竹區, 42768, 21052, 63820, 129252
c11, 桃園市, 觀音區, 18060, 8670, 26730, 55149
c11, 桃園市, 龍潭區, 36975, 15576, 52551, 101574
c11, 桃園市, 龜山區, 40956, 21628, 62584, 131702
c11, 澎湖縣, , 27546, 11418, 38964, 90405
c11, 澎湖縣, 七美鄉, 644, 325, 969, 3374
c11, 澎湖縣, 望安鄉, 1270, 535, 1805, 4628
c11, 澎湖縣, 湖西鄉, 3855, 1456, 5311, 12741
c11, 澎湖縣, 白沙鄉, 2506, 961, 3467, 8625
c11, 澎湖縣, 西嶼鄉, 1620, 678, 2298, 7382
c11, 澎湖縣, 馬公市, 17651, 7463, 25114, 53655
c11, 臺中市, , 868563, 406665, 1275228, 2295642
c11, 臺中市, 中區, 5461, 2373, 7834, 14696
c11, 臺中市, 北區, 45623, 22559, 68182, 124621
c11, 臺中市, 北屯區, 85446, 40801, 126247, 227720
c11, 臺中市, 南區, 40885, 20374, 61259, 103643
c11, 臺中市, 南屯區, 52490, 26682, 79172, 135448
c11, 臺中市, 后里區, 16916, 7801, 24717, 44962
c11, 臺中市, 和平區, 4135, 1469, 5604, 9498
c11, 臺中市, 外埔區, 10586, 4461, 15047, 27059
c11, 臺中市, 大安區, 6273, 2753, 9026, 16520
c11, 臺中市, 大甲區, 24051, 10532, 34583, 63069
c11, 臺中市, 大肚區, 18118, 8063, 26181, 47457
c11, 臺中市, 大里區, 63580, 28967, 92547, 171769
c11, 臺中市, 大雅區, 29388, 13270, 42658, 77189
c11, 臺中市, 太平區, 57059, 25896, 82955, 157926
c11, 臺中市, 新社區, 7761, 2917, 10678, 20860
c11, 臺中市, 東勢區, 17480, 6486, 23966, 43181
c11, 臺中市, 東區, 24849, 11683, 36532, 64291
c11, 臺中市, 梧棲區, 17011, 8468, 25479, 47040
c11, 臺中市, 沙鹿區, 27449, 12792, 40241, 74207
c11, 臺中市, 清水區, 27102, 12389, 39491, 71528
c11, 臺中市, 潭子區, 34158, 15445, 49603, 89487
c11, 臺中市, 烏日區, 23651, 10951, 34602, 61705
c11, 臺中市, 石岡區, 4924, 2182, 7106, 12880
c11, 臺中市, 神岡區, 21304, 9614, 30918, 54565
c11, 臺中市, 西區, 35073, 18648, 53721, 95040
c11, 臺中市, 西屯區, 68518, 34238, 102756, 183814
c11, 臺中市, 豐原區, 53764, 24741, 78505, 136658
c11, 臺中市, 霧峰區, 21953, 9437, 31390, 55225
c11, 臺中市, 龍井區, 23555, 10673, 34228, 63584
c11, 臺北市, , 779447, 462976, 1242423, 2228430
c11, 臺北市, 中山區, 66307, 40817, 107124, 195148
c11, 臺北市, 中正區, 45658, 26747, 72405, 128292
c11, 臺北市, 信義區, 67363, 39247, 106610, 190444
c11, 臺北市, 內湖區, 83195, 50907, 134102, 236824
c11, 臺北市, 北投區, 72981, 42896, 115877, 213250
c11, 臺北市, 南港區, 35738, 21712, 57450, 101907
c11, 臺北市, 士林區, 82768, 50109, 132877, 241854
c11, 臺北市, 大同區, 36686, 23038, 59724, 107557
c11, 臺北市, 大安區, 88535, 52709, 141244, 252645
c11, 臺北市, 文山區, 84069, 47142, 131211, 227211
c11, 臺北市, 松山區, 60838, 35764, 96602, 169278
c11, 臺北市, 萬華區, 55309, 31888, 87197, 164020
c11, 臺南市, , 537623, 254622, 792245, 1594821
c11, 臺南市, 七股區, 6592, 2505, 9097, 19950
c11, 臺南市, 下營區, 6638, 2777, 9415, 20947
c11, 臺南市, 中西區, 23013, 11907, 34920, 65261
c11, 臺南市, 仁德區, 23066, 10194, 33260, 64632
c11, 臺南市, 佳里區, 17476, 7728, 25204, 50407
c11, 臺南市, 六甲區, 5759, 2850, 8609, 19144
c11, 臺南市, 北區, 38923, 19106, 58029, 110906
c11, 臺南市, 北門區, 2877, 1136, 4013, 9925
c11, 臺南市, 南化區, 2436, 1020, 3456, 7786
c11, 臺南市, 南區, 36989, 17349, 54338, 108650
c11, 臺南市, 善化區, 13383, 6569, 19952, 39950
c11, 臺南市, 大內區, 2824, 1111, 3935, 8654
c11, 臺南市, 學甲區, 7157, 3174, 10331, 22567
c11, 臺南市, 安南區, 54063, 26146, 80209, 159654
c11, 臺南市, 安定區, 9457, 4068, 13525, 26104
c11, 臺南市, 安平區, 18147, 9409, 27556, 55379
c11, 臺南市, 官田區, 5914, 2786, 8700, 18675
c11, 臺南市, 將軍區, 5782, 2179, 7961, 17754
c11, 臺南市, 山上區, 1895, 874, 2769, 6511
c11, 臺南市, 左鎮區, 1429, 492, 1921, 4418
c11, 臺南市, 後壁區, 6350, 2695, 9045, 20841
c11, 臺南市, 新化區, 13367, 5896, 19263, 37296
c11, 臺南市, 新市區, 10824, 4984, 15808, 30386
c11, 臺南市, 新營區, 21028, 10123, 31151, 64949
c11, 臺南市, 東區, 53914, 27491, 81405, 153359
c11, 臺南市, 東山區, 4753, 1967, 6720, 18471
c11, 臺南市, 柳營區, 6119, 2643, 8762, 18804
c11, 臺南市, 楠西區, 2651, 998, 3649, 8528
c11, 臺南市, 歸仁區, 19859, 9577, 29436, 57387
c11, 臺南市, 永康區, 66331, 32457, 98788, 195001
c11, 臺南市, 玉井區, 4277, 1474, 5751, 12357
c11, 臺南市, 白河區, 7052, 3223, 10275, 24894
c11, 臺南市, 西港區, 6625, 3138, 9763, 21564
c11, 臺南市, 關廟區, 10491, 4801, 15292, 29913
c11, 臺南市, 鹽水區, 6910, 3187, 10097, 22121
c11, 臺南市, 麻豆區, 12006, 6114, 18120, 37963
c11, 臺南市, 龍崎區, 1246, 474, 1720, 3713
c11, 臺東縣, , 65985, 26076, 92061, 185996
c11, 臺東縣, 卑南鄉, 5194, 2153, 7347, 14976
c11, 臺東縣, 大武鄉, 1874, 712, 2586, 5266
c11, 臺東縣, 太麻里鄉, 3792, 1252, 5044, 9666
c11, 臺東縣, 延平鄉, 1176, 462, 1638, 2930
c11, 臺東縣, 成功鎮, 4334, 1480, 5814, 12426
c11, 臺東縣, 東河鄉, 2281, 843, 3124, 7635
c11, 臺東縣, 池上鄉, 2041, 940, 2981, 7162
c11, 臺東縣, 海端鄉, 1215, 482, 1697, 3278
c11, 臺東縣, 綠島鄉, 1048, 489, 1537, 3579
c11, 臺東縣, 臺東市, 32943, 13026, 45969, 87803
c11, 臺東縣, 蘭嶼鄉, 999, 600, 1599, 4181
c11, 臺東縣, 達仁鄉, 1326, 471, 1797, 3137
c11, 臺東縣, 金峰鄉, 1425, 492, 1917, 3028
c11, 臺東縣, 長濱鄉, 1872, 691, 2563, 6484
c11, 臺東縣, 關山鎮, 2490, 1051, 3541, 7509
c11, 臺東縣, 鹿野鄉, 1975, 932, 2907, 6936
c11, 花蓮縣, , 99444, 40126, 139570, 278059
c11, 花蓮縣, 光復鄉, 4121, 1485, 5606, 11417
c11, 花蓮縣, 卓溪鄉, 2071, 681, 2752, 4947
c11, 花蓮縣, 吉安鄉, 25828, 10468, 36296, 72116
c11, 花蓮縣, 壽豐鄉, 5779, 2394, 8173, 15847
c11, 花蓮縣, 富里鄉, 2600, 1144, 3744, 9065
c11, 花蓮縣, 新城鄉, 6304, 2510, 8814, 17029
c11, 花蓮縣, 玉里鎮, 6862, 2490, 9352, 20650
c11, 花蓮縣, 瑞穗鄉, 3545, 1299, 4844, 10279
c11, 花蓮縣, 秀林鄉, 4352, 1869, 6221, 12562
c11, 花蓮縣, 花蓮市, 30824, 12989, 43813, 84807
c11, 花蓮縣, 萬榮鄉, 2116, 824, 2940, 5269
c11, 花蓮縣, 豐濱鄉, 1447, 592, 2039, 4395
c11, 花蓮縣, 鳳林鎮, 3595, 1381, 4976, 9676
c11, 苗栗縣, , 175397, 74340, 249737, 461580
c11, 苗栗縣, 三灣鄉, 2215, 927, 3142, 5852
c11, 苗栗縣, 三義鄉, 5554, 2183, 7737, 13889
c11, 苗栗縣, 公館鄉, 10842, 4804, 15646, 28318
c11, 苗栗縣, 卓蘭鎮, 5637, 2514, 8151, 14772
c11, 苗栗縣, 南庄鄉, 2800, 1253, 4053, 8784
c11, 苗栗縣, 大湖鄉, 4454, 1872, 6326, 12653
c11, 苗栗縣, 後龍鎮, 10907, 5134, 16041, 30948
c11, 苗栗縣, 泰安鄉, 2400, 925, 3325, 5180
c11, 苗栗縣, 獅潭鄉, 1402, 486, 1888, 3968
c11, 苗栗縣, 竹南鎮, 25657, 11311, 36968, 68528
c11, 苗栗縣, 苑裡鎮, 14746, 6423, 21169, 38890
c11, 苗栗縣, 苗栗市, 29311, 11785, 41096, 74249
c11, 苗栗縣, 西湖鄉, 2341, 983, 3324, 6382
c11, 苗栗縣, 通霄鎮, 10718, 4625, 15343, 29709
c11, 苗栗縣, 造橋鄉, 4225, 1791, 6016, 11027
c11, 苗栗縣, 銅鑼鄉, 5749, 2363, 8112, 15424
c11, 苗栗縣, 頭份市, 32171, 13439, 45610, 83617
c11, 苗栗縣, 頭屋鄉, 4268, 1522, 5790, 9390
c11, 連江縣, , 4131, 1461, 5592, 11205
c11, 連江縣, 北竿鄉, 802, 270, 1072, 2125
c11, 連江縣, 南竿鄉, 2385, 796, 3181, 6461
c11, 連江縣, 東引鄉, 400, 170, 570, 1138
c11, 連江縣, 莒光鄉, 544, 225, 769, 1481
c11, 金門縣, , 30593, 11206, 41799, 122695
c11, 金門縣, 烈嶼鄉, 3063, 965, 4028, 11676
c11, 金門縣, 烏坵鄉, 125, 34, 159, 567
c11, 金門縣, 金城鎮, 9373, 3247, 12620, 37815
c11, 金門縣, 金寧鄉, 6500, 3260, 9760, 28162
c11, 金門縣, 金沙鎮, 4856, 1367, 6223, 18560
c11, 金門縣, 金湖鎮, 6676, 2333, 9009, 25915
c11, 雲林縣, , 196214, 88271, 284485, 584480
c11, 雲林縣, 二崙鄉, 6969, 3256, 10225, 23367
c11, 雲林縣, 元長鄉, 6424, 2790, 9214, 22830
c11, 雲林縣, 北港鎮, 11976, 5371, 17347, 33958
c11, 雲林縣, 口湖鄉, 7386, 3160, 10546, 24193
c11, 雲林縣, 古坑鄉, 9531, 4178, 13709, 27477
c11, 雲林縣, 四湖鄉, 5432, 2260, 7692, 20983
c11, 雲林縣, 土庫鎮, 8315, 3744, 12059, 24412
c11, 雲林縣, 大埤鄉, 5518, 2526, 8044, 16509
c11, 雲林縣, 崙背鄉, 6639, 2894, 9533, 21050
c11, 雲林縣, 斗六市, 33938, 15650, 49588, 89761
c11, 雲林縣, 斗南鎮, 14373, 6241, 20614, 38138
c11, 雲林縣, 東勢鄉, 4225, 1866, 6091, 13239
c11, 雲林縣, 林內鄉, 5670, 2494, 8164, 15551
c11, 雲林縣, 水林鄉, 6291, 2698, 8989, 22508
c11, 雲林縣, 臺西鄉, 6443, 2561, 9004, 21125
c11, 雲林縣, 莿桐鄉, 8646, 3946, 12592, 24570
c11, 雲林縣, 虎尾鎮, 20035, 9568, 29603, 58167
c11, 雲林縣, 褒忠鄉, 3677, 1798, 5475, 11381
c11, 雲林縣, 西螺鎮, 12953, 6017, 18970, 38142
c11, 雲林縣, 麥寮鄉, 11773, 5253, 17026, 37119
c11, 高雄市, , 934858, 413374, 1348232, 2353342
c11, 高雄市, 三民區, 114862, 54188, 169050, 289519
c11, 高雄市, 仁武區, 29527, 12770, 42297, 73611
c11, 高雄市, 內門區, 4380, 1717, 6097, 13002
c11, 高雄市, 六龜區, 3535, 1464, 4999, 11501
c11, 高雄市, 前金區, 9711, 4547, 14258, 23928
c11, 高雄市, 前鎮區, 63672, 28519, 92191, 161797
c11, 高雄市, 大寮區, 38167, 15802, 53969, 97309
c11, 高雄市, 大樹區, 13883, 5704, 19587, 36772
c11, 高雄市, 大社區, 11060, 5656, 16716, 30046
c11, 高雄市, 小港區, 52471, 23338, 75809, 132733
c11, 高雄市, 岡山區, 34306, 14078, 48384, 81244
c11, 高雄市, 左營區, 66941, 29138, 96079, 161367
c11, 高雄市, 彌陀區, 6857, 2749, 9606, 16487
c11, 高雄市, 新興區, 17782, 8806, 26588, 44355
c11, 高雄市, 旗山區, 11950, 5192, 17142, 31996
c11, 高雄市, 旗津區, 9013, 3854, 12867, 24860
c11, 高雄市, 杉林區, 3336, 1323, 4659, 10607
c11, 高雄市, 林園區, 21650, 9762, 31412, 59129
c11, 高雄市, 桃源區, 1615, 547, 2162, 3498
c11, 高雄市, 梓官區, 12908, 4912, 17820, 31025
c11, 高雄市, 楠梓區, 61146, 26996, 88142, 153132
c11, 高雄市, 橋頭區, 13696, 5911, 19607, 32565
c11, 高雄市, 永安區, 5024, 2184, 7208, 12001
c11, 高雄市, 湖內區, 9636, 4230, 13866, 25729
c11, 高雄市, 燕巢區, 9918, 4252, 14170, 26012
c11, 高雄市, 田寮區, 2120, 895, 3015, 6671
c11, 高雄市, 甲仙區, 1740, 736, 2476, 5417
c11, 高雄市, 美濃區, 13222, 4696, 17918, 35311
c11, 高雄市, 苓雅區, 60784, 27867, 88651, 146786
c11, 高雄市, 茂林區, 812, 263, 1075, 1615
c11, 高雄市, 茄萣區, 9593, 3958, 13551, 26212
c11, 高雄市, 路竹區, 17063, 7678, 24741, 43850
c11, 高雄市, 那瑪夏區, 1311, 358, 1669, 2424
c11, 高雄市, 阿蓮區, 8913, 3926, 12839, 24534
c11, 高雄市, 鳥松區, 15786, 7300, 23086, 39191
c11, 高雄市, 鳳山區, 121790, 53188, 174978, 300510
c11, 高雄市, 鹽埕區, 8291, 4133, 12424, 21617
c11, 高雄市, 鼓山區, 46387, 20737, 67124, 114979
c12, 全國, , 6401748, 4072471, 10474219, 19757067
c12, 南投縣, , 143356, 91565, 234921, 427089
c12, 南投縣, 中寮鄉, 4197, 2902, 7099, 13181
c12, 南投縣, 仁愛鄉, 4375, 2503, 6878, 12589
c12, 南投縣, 信義鄉, 5655, 2337, 7992, 13299
c12, 南投縣, 南投市, 30688, 18233, 48921, 84328
c12, 南投縣, 名間鄉, 11518, 7257, 18775, 33408
c12, 南投縣, 國姓鄉, 5242, 3437, 8679, 16597
c12, 南投縣, 埔里鎮, 22909, 14653, 37562, 68763
c12, 南投縣, 水里鄉, 4880, 3232, 8112, 15458
c12, 南投縣, 竹山鎮, 14445, 10060, 24505, 47034
c12, 南投縣, 草屯鎮, 27781, 18359, 46140, 82922
c12, 南投縣, 集集鎮, 2990, 2213, 5203, 9611
c12, 南投縣, 魚池鄉, 4019, 3031, 7050, 13958
c12, 南投縣, 鹿谷鄉, 4657, 3348, 8005, 15941
c12, 嘉義市, , 73821, 44563, 118384, 221553
c12, 嘉義市, 東區, 33406, 20228, 53634, 100647
c12, 嘉義市, 西區, 40415, 24335, 64750, 120906
c12, 嘉義縣, , 132636, 81825, 214461, 442775
c12, 嘉義縣, 中埔鄉, 10814, 6970, 17784, 39139
c12, 嘉義縣, 六腳鄉, 5217, 3177, 8394, 20821
c12, 嘉義縣, 大埔鄉, 1280, 822, 2102, 3999
c12, 嘉義縣, 大林鎮, 8075, 5293, 13368, 26922
c12, 嘉義縣, 太保市, 9940, 6382, 16322, 31568
c12, 嘉義縣, 布袋鎮, 6938, 4035, 10973, 23965
c12, 嘉義縣, 新港鄉, 8563, 5310, 13873, 27342
c12, 嘉義縣, 朴子市, 10800, 6642, 17442, 35191
c12, 嘉義縣, 東石鄉, 5453, 2984, 8437, 21915
c12, 嘉義縣, 梅山鄉, 5569, 3298, 8867, 17083
c12, 嘉義縣, 民雄鄉, 19293, 11995, 31288, 61209
c12, 嘉義縣, 水上鄉, 13744, 8519, 22263, 43857
c12, 嘉義縣, 溪口鄉, 4086, 2363, 6449, 13105
c12, 嘉義縣, 番路鄉, 3278, 2041, 5319, 10156
c12, 嘉義縣, 竹崎鄉, 9650, 5888, 15538, 31228
c12, 嘉義縣, 義竹鄉, 4946, 2911, 7857, 16647
c12, 嘉義縣, 阿里山鄉, 1277, 835, 2112, 4691
c12, 嘉義縣, 鹿草鄉, 3713, 2360, 6073, 13937
c12, 基隆市, , 96333, 62976, 159309, 320030
c12, 基隆市, 七堵區, 14532, 9137, 23669, 46256
c12, 基隆市, 中山區, 12443, 8188, 20631, 41856
c12, 基隆市, 中正區, 12322, 8255, 20577, 45545
c12, 基隆市, 仁愛區, 11401, 7385, 18786, 36738
c12, 基隆市, 信義區, 14305, 9162, 23467, 46014
c12, 基隆市, 安樂區, 21005, 14155, 35160, 70396
c12, 基隆市, 暖暖區, 10325, 6694, 17019, 33225
c12, 宜蘭縣, , 119746, 83726, 203472, 386089
c12, 宜蘭縣, 三星鄉, 5535, 3892, 9427, 19051
c12, 宜蘭縣, 五結鄉, 10228, 7412, 17640, 34892
c12, 宜蘭縣, 冬山鄉, 13199, 9936, 23135, 45405
c12, 宜蘭縣, 南澳鄉, 1900, 879, 2779, 4644
c12, 宜蘭縣, 員山鄉, 8311, 5917, 14228, 28131
c12, 宜蘭縣, 壯圍鄉, 6976, 4687, 11663, 21447
c12, 宜蘭縣, 大同鄉, 2548, 867, 3415, 4935
c12, 宜蘭縣, 宜蘭市, 25673, 17297, 42970, 79167
c12, 宜蘭縣, 礁溪鄉, 9089, 6782, 15871, 31084
c12, 宜蘭縣, 羅東鎮, 18673, 12875, 31548, 57686
c12, 宜蘭縣, 蘇澳鎮, 10125, 7865, 17990, 34512
c12, 宜蘭縣, 頭城鎮, 7489, 5317, 12806, 25135
c12, 屏東縣, , 216753, 136224, 352977, 711720
c12, 屏東縣, 三地門鄉, 2519, 1274, 3793, 6373
c12, 屏東縣, 九如鄉, 5776, 3695, 9471, 19132
c12, 屏東縣, 佳冬鄉, 4877, 2953, 7830, 17063
c12, 屏東縣, 來義鄉, 2423, 1131, 3554, 6257
c12, 屏東縣, 內埔鄉, 13292, 8506, 21798, 47558
c12, 屏東縣, 南州鄉, 2779, 1937, 4716, 9479
c12, 屏東縣, 屏東市, 53638, 33114, 86752, 170148
c12, 屏東縣, 崁頂鄉, 3662, 2334, 5996, 12270
c12, 屏東縣, 恆春鎮, 6419, 4918, 11337, 25661
c12, 屏東縣, 新園鄉, 9147, 5827, 14974, 30706
c12, 屏東縣, 新埤鄉, 2559, 1660, 4219, 9033
c12, 屏東縣, 春日鄉, 1095, 605, 1700, 3923
c12, 屏東縣, 東港鎮, 11765, 7877, 19642, 39495
c12, 屏東縣, 枋寮鄉, 6469, 4070, 10539, 21394
c12, 屏東縣, 枋山鄉, 1441, 899, 2340, 4856
c12, 屏東縣, 林邊鄉, 5149, 3009, 8158, 15691
c12, 屏東縣, 泰武鄉, 1763, 992, 2755, 4344
c12, 屏東縣, 滿州鄉, 1674, 1268, 2942, 7206
c12, 屏東縣, 潮州鎮, 14538, 8696, 23234, 46444
c12, 屏東縣, 牡丹鄉, 1042, 744, 1786, 4314
c12, 屏東縣, 獅子鄉, 1814, 748, 2562, 4230
c12, 屏東縣, 琉球鄉, 2812, 1611, 4423, 10706
c12, 屏東縣, 瑪家鄉, 2430, 1185, 3615, 5663
c12, 屏東縣, 竹田鄉, 5021, 3157, 8178, 15353
c12, 屏東縣, 萬丹鄉, 13536, 8355, 21891, 43478
c12, 屏東縣, 萬巒鄉, 5074, 3640, 8714, 17945
c12, 屏東縣, 車城鄉, 1698, 1269, 2967, 7595
c12, 屏東縣, 里港鄉, 6740, 4569, 11309, 22128
c12, 屏東縣, 長治鄉, 8236, 5259, 13495, 26256
c12, 屏東縣, 霧臺鄉, 1573, 609, 2182, 2950
c12, 屏東縣, 高樹鄉, 5804, 3989, 9793, 21697
c12, 屏東縣, 鹽埔鄉, 6444, 4323, 10767, 22402
c12, 屏東縣, 麟洛鄉, 3544, 2001, 5545, 9970
c12, 彰化縣, , 356924, 224371, 581295, 1066994
c12, 彰化縣, 二林鎮, 13211, 8115, 21326, 42976
c12, 彰化縣, 二水鄉, 4983, 2611, 7594, 13339
c12, 彰化縣, 伸港鄉, 9720, 6433, 16153, 30407
c12, 彰化縣, 北斗鎮, 9465, 5748, 15213, 27593
c12, 彰化縣, 和美鎮, 24610, 16291, 40901, 75286
c12, 彰化縣, 員林市, 33660, 21760, 55420, 102028
c12, 彰化縣, 埔心鄉, 10317, 6885, 17202, 29642
c12, 彰化縣, 埔鹽鄉, 9874, 6020, 15894, 28026
c12, 彰化縣, 埤頭鄉, 7832, 5029, 12861, 25677
c12, 彰化縣, 大城鄉, 3240, 2026, 5266, 14713
c12, 彰化縣, 大村鄉, 10702, 6852, 17554, 31492
c12, 彰化縣, 彰化市, 68788, 41730, 110518, 190995
c12, 彰化縣, 永靖鄉, 10584, 7076, 17660, 31239
c12, 彰化縣, 溪州鄉, 7390, 4986, 12376, 25405
c12, 彰化縣, 溪湖鎮, 15354, 9656, 25010, 45147
c12, 彰化縣, 田中鎮, 12217, 7289, 19506, 35391
c12, 彰化縣, 田尾鄉, 7969, 4930, 12899, 23179
c12, 彰化縣, 社頭鄉, 11701, 8292, 19993, 36306
c12, 彰化縣, 福興鄉, 12923, 7536, 20459, 39745
c12, 彰化縣, 秀水鄉, 11216, 7005, 18221, 32394
c12, 彰化縣, 竹塘鄉, 3755, 2717, 6472, 12821
c12, 彰化縣, 線西鄉, 4751, 3117, 7868, 14065
c12, 彰化縣, 芬園鄉, 6526, 4148, 10674, 20408
c12, 彰化縣, 花壇鄉, 14186, 7908, 22094, 38924
c12, 彰化縣, 芳苑鄉, 8085, 5166, 13251, 29291
c12, 彰化縣, 鹿港鎮, 23865, 15045, 38910, 70505
c12, 新北市, , 1070300, 712548, 1782848, 3375513
c12, 新北市, 三峽區, 28622, 18860, 47482, 94291
c12, 新北市, 三芝區, 5384, 3787, 9171, 20119
c12, 新北市, 三重區, 101972, 72085, 174057, 329846
c12, 新北市, 中和區, 117533, 72733, 190266, 355978
c12, 新北市, 五股區, 22210, 14665, 36875, 72443
c12, 新北市, 八里區, 9599, 6978, 16577, 32970
c12, 新北市, 土城區, 62655, 42571, 105226, 200783
c12, 新北市, 坪林區, 1714, 1089, 2803, 5891
c12, 新北市, 平溪區, 1218, 703, 1921, 4321
c12, 新北市, 新店區, 88798, 54809, 143607, 264053
c12, 新北市, 新莊區, 111089, 76839, 187928, 344981
c12, 新北市, 板橋區, 153500, 98590, 252090, 463411
c12, 新北市, 林口區, 27446, 18805, 46251, 86203
c12, 新北市, 樹林區, 47189, 32946, 80135, 152102
c12, 新北市, 永和區, 65391, 41209, 106600, 187798
c12, 新北市, 汐止區, 52092, 35719, 87811, 173831
c12, 新北市, 泰山區, 20423, 13613, 34036, 64252
c12, 新北市, 淡水區, 44720, 29981, 74701, 147272
c12, 新北市, 深坑區, 6399, 4483, 10882, 20624
c12, 新北市, 烏來區, 1773, 1018, 2791, 5264
c12, 新北市, 瑞芳區, 9374, 6355, 15729, 35036
c12, 新北市, 石碇區, 1895, 1359, 3254, 6861
c12, 新北市, 石門區, 2955, 2092, 5047, 10528
c12, 新北市, 萬里區, 5433, 3538, 8971, 19297
c12, 新北市, 蘆洲區, 49602, 35657, 85259, 167457
c12, 新北市, 貢寮區, 2649, 1939, 4588, 11279
c12, 新北市, 金山區, 5228, 3653, 8881, 18978
c12, 新北市, 雙溪區, 2122, 1476, 3598, 7999
c12, 新北市, 鶯歌區, 21315, 14996, 36311, 71645
c12, 新竹市, , 116724, 75092, 191816, 351775
c12, 新竹市, 北區, 40483, 25931, 66414, 123122
c12, 新竹市, 東區, 54827, 35588, 90415, 163757
c12, 新竹市, 香山區, 21414, 13573, 34987, 64896
c12, 新竹縣, , 150580, 92309, 242889, 445051
c12, 新竹縣, 五峰鄉, 1357, 756, 2113, 3997
c12, 新竹縣, 北埔鄉, 2705, 1710, 4415, 8180
c12, 新竹縣, 寶山鄉, 4360, 2952, 7312, 12973
c12, 新竹縣, 尖石鄉, 2848, 1278, 4126, 7364
c12, 新竹縣, 峨眉鄉, 1841, 1018, 2859, 5068
c12, 新竹縣, 新埔鎮, 9575, 5965, 15540, 28894
c12, 新竹縣, 新豐鄉, 15412, 9190, 24602, 45790
c12, 新竹縣, 橫山鄉, 3721, 2562, 6283, 11346
c12, 新竹縣, 湖口鄉, 21141, 13123, 34264, 63511
c12, 新竹縣, 竹北市, 47451, 29863, 77314, 137129
c12, 新竹縣, 竹東鎮, 25690, 15323, 41013, 78794
c12, 新竹縣, 芎林鄉, 6128, 3570, 9698, 17293
c12, 新竹縣, 關西鎮, 8351, 4999, 13350, 24712
c12, 桃園市, , 540236, 352795, 893031, 1801823
c12, 桃園市, 中壢區, 104348, 65472, 169820, 334402
c12, 桃園市, 八德區, 47532, 31746, 79278, 165065
c12, 桃園市, 大園區, 20740, 14918, 35658, 73900
c12, 桃園市, 大溪區, 23559, 15578, 39137, 78285
c12, 桃園市, 平鎮區, 57526, 36277, 93803, 183560
c12, 桃園市, 復興區, 3512, 1805, 5317, 9766
c12, 桃園市, 新屋區, 12741, 9152, 21893, 41461
c12, 桃園市, 桃園區, 104081, 71688, 175769, 359790
c12, 桃園市, 楊梅區, 41994, 25313, 67307, 137917
c12, 桃園市, 蘆竹區, 38396, 25321, 63717, 129252
c12, 桃園市, 觀音區, 15302, 11210, 26512, 55149
c12, 桃園市, 龍潭區, 33953, 18573, 52526, 101574
c12, 桃園市, 龜山區, 36552, 25742, 62294, 131702
c12, 澎湖縣, , 24658, 14157, 38815, 90405
c12, 澎湖縣, 七美鄉, 553, 396, 949, 3374
c12, 澎湖縣, 望安鄉, 1177, 616, 1793, 4628
c12, 澎湖縣, 湖西鄉, 3346, 1956, 5302, 12741
c12, 澎湖縣, 白沙鄉, 2284, 1171, 3455, 8625
c12, 澎湖縣, 西嶼鄉, 1439, 866, 2305, 7382
c12, 澎湖縣, 馬公市, 15859, 9152, 25011, 53655
c12, 臺中市, , 777273, 490959, 1268232, 2295642
c12, 臺中市, 中區, 4828, 3021, 7849, 14696
c12, 臺中市, 北區, 41580, 26168, 67748, 124621
c12, 臺中市, 北屯區, 77474, 47717, 125191, 227720
c12, 臺中市, 南區, 37710, 23028, 60738, 103643
c12, 臺中市, 南屯區, 48668, 29856, 78524, 135448
c12, 臺中市, 后里區, 14278, 10266, 24544, 44962
c12, 臺中市, 和平區, 3507, 2116, 5623, 9498
c12, 臺中市, 外埔區, 9162, 5824, 14986, 27059
c12, 臺中市, 大安區, 5373, 3626, 8999, 16520
c12, 臺中市, 大甲區, 21418, 13192, 34610, 63069
c12, 臺中市, 大肚區, 15756, 10368, 26124, 47457
c12, 臺中市, 大里區, 56856, 35523, 92379, 171769
c12, 臺中市, 大雅區, 25855, 16532, 42387, 77189
c12, 臺中市, 太平區, 50405, 31955, 82360, 157926
c12, 臺中市, 新社區, 6763, 3969, 10732, 20860
c12, 臺中市, 東勢區, 15459, 8291, 23750, 43181
c12, 臺中市, 東區, 22105, 14057, 36162, 64291
c12, 臺中市, 梧棲區, 14659, 10642, 25301, 47040
c12, 臺中市, 沙鹿區, 24395, 15729, 40124, 74207
c12, 臺中市, 清水區, 23845, 15541, 39386, 71528
c12, 臺中市, 潭子區, 30585, 18753, 49338, 89487
c12, 臺中市, 烏日區, 20786, 13436, 34222, 61705
c12, 臺中市, 石岡區, 4303, 2820, 7123, 12880
c12, 臺中市, 神岡區, 18494, 12285, 30779, 54565
c12, 臺中市, 西區, 32508, 20953, 53461, 95040
c12, 臺中市, 西屯區, 62843, 39525, 102368, 183814
c12, 臺中市, 豐原區, 47705, 30372, 78077, 136658
c12, 臺中市, 霧峰區, 19150, 12175, 31325, 55225
c12, 臺中市, 龍井區, 20803, 13219, 34022, 63584
c12, 臺北市, , 732239, 506433, 1238672, 2228430
c12, 臺北市, 中山區, 62130, 44981, 107111, 195148
c12, 臺北市, 中正區, 42868, 29334, 72202, 128292
c12, 臺北市, 信義區, 62853, 43324, 106177, 190444
c12, 臺北市, 內湖區, 79459, 54312, 133771, 236824
c12, 臺北市, 北投區, 68267, 47236, 115503, 213250
c12, 臺北市, 南港區, 33203, 23931, 57134, 101907
c12, 臺北市, 士林區, 78172, 54400, 132572, 241854
c12, 臺北市, 大同區, 34138, 25407, 59545, 107557
c12, 臺北市, 大安區, 83730, 56964, 140694, 252645
c12, 臺北市, 文山區, 78865, 51554, 130419, 227211
c12, 臺北市, 松山區, 57656, 38733, 96389, 169278
c12, 臺北市, 萬華區, 50898, 36257, 87155, 164020
c12, 臺南市, , 494543, 297390, 791933, 1594821
c12, 臺南市, 七股區, 6034, 3102, 9136, 19950
c12, 臺南市, 下營區, 5843, 3463, 9306, 20947
c12, 臺南市, 中西區, 21715, 13138, 34853, 65261
c12, 臺南市, 仁德區, 21284, 12041, 33325, 64632
c12, 臺南市, 佳里區, 15891, 9346, 25237, 50407
c12, 臺南市, 六甲區, 4985, 3615, 8600, 19144
c12, 臺南市, 北區, 36584, 21480, 58064, 110906
c12, 臺南市, 北門區, 2592, 1437, 4029, 9925
c12, 臺南市, 南化區, 2076, 1360, 3436, 7786
c12, 臺南市, 南區, 34717, 19769, 54486, 108650
c12, 臺南市, 善化區, 12284, 7483, 19767, 39950
c12, 臺南市, 大內區, 2472, 1449, 3921, 8654
c12, 臺南市, 學甲區, 6362, 3995, 10357, 22567
c12, 臺南市, 安南區, 49901, 30383, 80284, 159654
c12, 臺南市, 安定區, 8558, 4965, 13523, 26104
c12, 臺南市, 安平區, 17056, 10422, 27478, 55379
c12, 臺南市, 官田區, 5317, 3399, 8716, 18675
c12, 臺南市, 將軍區, 5090, 2608, 7698, 17754
c12, 臺南市, 山上區, 1677, 1053, 2730, 6511
c12, 臺南市, 左鎮區, 1294, 651, 1945, 4418
c12, 臺南市, 後壁區, 5708, 3399, 9107, 20841
c12, 臺南市, 新化區, 11884, 7090, 18974, 37296
c12, 臺南市, 新市區, 9683, 6045, 15728, 30386
c12, 臺南市, 新營區, 19145, 12148, 31293, 64949
c12, 臺南市, 東區, 51215, 30051, 81266, 153359
c12, 臺南市, 東山區, 4205, 2542, 6747, 18471
c12, 臺南市, 柳營區, 5488, 3282, 8770, 18804
c12, 臺南市, 楠西區, 2258, 1348, 3606, 8528
c12, 臺南市, 歸仁區, 18463, 11144, 29607, 57387
c12, 臺南市, 永康區, 61149, 37817, 98966, 195001
c12, 臺南市, 玉井區, 3583, 2062, 5645, 12357
c12, 臺南市, 白河區, 6314, 4007, 10321, 24894
c12, 臺南市, 西港區, 5967, 3791, 9758, 21564
c12, 臺南市, 關廟區, 9556, 5839, 15395, 29913
c12, 臺南市, 鹽水區, 6222, 3916, 10138, 22121
c12, 臺南市, 麻豆區, 10865, 7111, 17976, 37963
c12, 臺南市, 龍崎區, 1106, 639, 1745, 3713
c12, 臺東縣, , 57826, 34122, 91948, 185996
c12, 臺東縣, 卑南鄉, 4552, 2778, 7330, 14976
c12, 臺東縣, 大武鄉, 1903, 682, 2585, 5266
c12, 臺東縣, 太麻里鄉, 3374, 1678, 5052, 9666
c12, 臺東縣, 延平鄉, 1062, 548, 1610, 2930
c12, 臺東縣, 成功鎮, 3596, 2245, 5841, 12426
c12, 臺東縣, 東河鄉, 1990, 1176, 3166, 7635
c12, 臺東縣, 池上鄉, 1704, 1294, 2998, 7162
c12, 臺東縣, 海端鄉, 1002, 680, 1682, 3278
c12, 臺東縣, 綠島鄉, 945, 585, 1530, 3579
c12, 臺東縣, 臺東市, 28924, 16982, 45906, 87803
c12, 臺東縣, 蘭嶼鄉, 854, 741, 1595, 4181
c12, 臺東縣, 達仁鄉, 1207, 566, 1773, 3137
c12, 臺東縣, 金峰鄉, 1285, 627, 1912, 3028
c12, 臺東縣, 長濱鄉, 1623, 931, 2554, 6484
c12, 臺東縣, 關山鎮, 2116, 1392, 3508, 7509
c12, 臺東縣, 鹿野鄉, 1689, 1217, 2906, 6936
c12, 花蓮縣, , 86680, 53334, 140014, 278059
c12, 花蓮縣, 光復鄉, 3542, 2088, 5630, 11417
c12, 花蓮縣, 卓溪鄉, 1731, 1067, 2798, 4947
c12, 花蓮縣, 吉安鄉, 22580, 14036, 36616, 72116
c12, 花蓮縣, 壽豐鄉, 4999, 3250, 8249, 15847
c12, 花蓮縣, 富里鄉, 2126, 1656, 3782, 9065
c12, 花蓮縣, 新城鄉, 5272, 3498, 8770, 17029
c12, 花蓮縣, 玉里鎮, 5927, 3385, 9312, 20650
c12, 花蓮縣, 瑞穗鄉, 2976, 1826, 4802, 10279
c12, 花蓮縣, 秀林鄉, 3727, 2490, 6217, 12562
c12, 花蓮縣, 花蓮市, 27589, 16285, 43874, 84807
c12, 花蓮縣, 萬榮鄉, 1857, 1096, 2953, 5269
c12, 花蓮縣, 豐濱鄉, 1271, 774, 2045, 4395
c12, 花蓮縣, 鳳林鎮, 3083, 1883, 4966, 9676
c12, 苗栗縣, , 153026, 95793, 248819, 461580
c12, 苗栗縣, 三灣鄉, 1914, 1269, 3183, 5852
c12, 苗栗縣, 三義鄉, 4765, 2951, 7716, 13889
c12, 苗栗縣, 公館鄉, 9209, 6429, 15638, 28318
c12, 苗栗縣, 卓蘭鎮, 4969, 3120, 8089, 14772
c12, 苗栗縣, 南庄鄉, 2369, 1691, 4060, 8784
c12, 苗栗縣, 大湖鄉, 3818, 2459, 6277, 12653
c12, 苗栗縣, 後龍鎮, 9377, 6583, 15960, 30948
c12, 苗栗縣, 泰安鄉, 2032, 1249, 3281, 5180
c12, 苗栗縣, 獅潭鄉, 1166, 700, 1866, 3968
c12, 苗栗縣, 竹南鎮, 22781, 14039, 36820, 68528
c12, 苗栗縣, 苑裡鎮, 12787, 8254, 21041, 38890
c12, 苗栗縣, 苗栗市, 25845, 15204, 41049, 74249
c12, 苗栗縣, 西湖鄉, 1975, 1337, 3312, 6382
c12, 苗栗縣, 通霄鎮, 9439, 5897, 15336, 29709
c12, 苗栗縣, 造橋鄉, 3616, 2359, 5975, 11027
c12, 苗栗縣, 銅鑼鄉, 4785, 3303, 8088, 15424
c12, 苗栗縣, 頭份市, 28607, 16747, 45354, 83617
c12, 苗栗縣, 頭屋鄉, 3572, 2202, 5774, 9390
c12, 連江縣, , 3599, 1925, 5524, 11205
c12, 連江縣, 北竿鄉, 713, 347, 1060, 2125
c12, 連江縣, 南竿鄉, 2094, 1064, 3158, 6461
c12, 連江縣, 東引鄉, 325, 225, 550, 1138
c12, 連江縣, 莒光鄉, 467, 289, 756, 1481
c12, 金門縣, , 26932, 14773, 41705, 122695
c12, 金門縣, 烈嶼鄉, 2711, 1293, 4004, 11676
c12, 金門縣, 烏坵鄉, 113, 46, 159, 567
c12, 金門縣, 金城鎮, 8177, 4455, 12632, 37815
c12, 金門縣, 金寧鄉, 5802, 3895, 9697, 28162
c12, 金門縣, 金沙鎮, 4266, 1966, 6232, 18560
c12, 金門縣, 金湖鎮, 5863, 3118, 8981, 25915
c12, 雲林縣, , 170393, 114101, 284494, 584480
c12, 雲林縣, 二崙鄉, 6035, 4230, 10265, 23367
c12, 雲林縣, 元長鄉, 5559, 3683, 9242, 22830
c12, 雲林縣, 北港鎮, 10470, 6854, 17324, 33958
c12, 雲林縣, 口湖鄉, 6409, 4123, 10532, 24193
c12, 雲林縣, 古坑鄉, 8316, 5364, 13680, 27477
c12, 雲林縣, 四湖鄉, 4509, 3123, 7632, 20983
c12, 雲林縣, 土庫鎮, 7060, 4803, 11863, 24412
c12, 雲林縣, 大埤鄉, 4704, 3339, 8043, 16509
c12, 雲林縣, 崙背鄉, 5759, 3820, 9579, 21050
c12, 雲林縣, 斗六市, 29976, 19543, 49519, 89761
c12, 雲林縣, 斗南鎮, 12689, 8180, 20869, 38138
c12, 雲林縣, 東勢鄉, 3613, 2464, 6077, 13239
c12, 雲林縣, 林內鄉, 4885, 3241, 8126, 15551
c12, 雲林縣, 水林鄉, 5377, 3703, 9080, 22508
c12, 雲林縣, 臺西鄉, 5471, 3451, 8922, 21125
c12, 雲林縣, 莿桐鄉, 7420, 5098, 12518, 24570
c12, 雲林縣, 虎尾鎮, 17512, 12095, 29607, 58167
c12, 雲林縣, 褒忠鄉, 3162, 2292, 5454, 11381
c12, 雲林縣, 西螺鎮, 11288, 7807, 19095, 38142
c12, 雲林縣, 麥寮鄉, 10179, 6888, 17067, 37119
c12, 高雄市, , 857170, 491490, 1348660, 2353342
c12, 高雄市, 三民區, 105825, 62821, 168646, 289519
c12, 高雄市, 仁武區, 26855, 15402, 42257, 73611
c12, 高雄市, 內門區, 3884, 2209, 6093, 13002
c12, 高雄市, 六龜區, 3037, 1953, 4990, 11501
c12, 高雄市, 前金區, 8879, 5187, 14066, 23928
c12, 高雄市, 前鎮區, 58902, 33299, 92201, 161797
c12, 高雄市, 大寮區, 34853, 19237, 54090, 97309
c12, 高雄市, 大樹區, 12360, 7416, 19776, 36772
c12, 高雄市, 大社區, 10157, 6617, 16774, 30046
c12, 高雄市, 小港區, 47424, 28577, 76001, 132733
c12, 高雄市, 岡山區, 31396, 17088, 48484, 81244
c12, 高雄市, 左營區, 62982, 33114, 96096, 161367
c12, 高雄市, 彌陀區, 6341, 3444, 9785, 16487
c12, 高雄市, 新興區, 16846, 9906, 26752, 44355
c12, 高雄市, 旗山區, 10513, 6610, 17123, 31996
c12, 高雄市, 旗津區, 8235, 4564, 12799, 24860
c12, 高雄市, 杉林區, 2899, 1789, 4688, 10607
c12, 高雄市, 林園區, 19699, 12191, 31890, 59129
c12, 高雄市, 桃源區, 1448, 715, 2163, 3498
c12, 高雄市, 梓官區, 11724, 6183, 17907, 31025
c12, 高雄市, 楠梓區, 55883, 31845, 87728, 153132
c12, 高雄市, 橋頭區, 12605, 6914, 19519, 32565
c12, 高雄市, 永安區, 4384, 2848, 7232, 12001
c12, 高雄市, 湖內區, 8678, 5207, 13885, 25729
c12, 高雄市, 燕巢區, 8895, 5268, 14163, 26012
c12, 高雄市, 田寮區, 1881, 1163, 3044, 6671
c12, 高雄市, 甲仙區, 1563, 957, 2520, 5417
c12, 高雄市, 美濃區, 11579, 6583, 18162, 35311
c12, 高雄市, 苓雅區, 56526, 31867, 88393, 146786
c12, 高雄市, 茂林區, 701, 376, 1077, 1615
c12, 高雄市, 茄萣區, 8596, 4999, 13595, 26212
c12, 高雄市, 路竹區, 15241, 9468, 24709, 43850
c12, 高雄市, 那瑪夏區, 1091, 506, 1597, 2424
c12, 高雄市, 阿蓮區, 7823, 5018, 12841, 24534
c12, 高雄市, 鳥松區, 14437, 8605, 23042, 39191
c12, 高雄市, 鳳山區, 112232, 62692, 174924, 300510
c12, 高雄市, 鹽埕區, 8007, 4481, 12488, 21617
c12, 高雄市, 鼓山區, 42789, 24371, 67160, 114979
c13, 全國, , 4763086, 5774556, 10537642, 19757067
c13, 南投縣, , 98462, 138563, 237025, 427089
c13, 南投縣, 中寮鄉, 3227, 3982, 7209, 13181
c13, 南投縣, 仁愛鄉, 2398, 4386, 6784, 12589
c13, 南投縣, 信義鄉, 2855, 4238, 7093, 13299
c13, 南投縣, 南投市, 20281, 28852, 49133, 84328
c13, 南投縣, 名間鄉, 8870, 10276, 19146, 33408
c13, 南投縣, 國姓鄉, 3596, 5452, 9048, 16597
c13, 南投縣, 埔里鎮, 14608, 23503, 38111, 68763
c13, 南投縣, 水里鄉, 3390, 4848, 8238, 15458
c13, 南投縣, 竹山鎮, 10910, 14061, 24971, 47034
c13, 南投縣, 草屯鎮, 19594, 26875, 46469, 82922
c13, 南投縣, 集集鎮, 2235, 3129, 5364, 9611
c13, 南投縣, 魚池鄉, 3070, 4159, 7229, 13958
c13, 南投縣, 鹿谷鄉, 3428, 4802, 8230, 15941
c13, 嘉義市, , 58391, 60171, 118562, 221553
c13, 嘉義市, 東區, 25763, 27911, 53674, 100647
c13, 嘉義市, 西區, 32628, 32260, 64888, 120906
c13, 嘉義縣, , 110830, 103993, 214823, 442775
c13, 嘉義縣, 中埔鄉, 8874, 8617, 17491, 39139
c13, 嘉義縣, 六腳鄉, 4734, 3723, 8457, 20821
c13, 嘉義縣, 大埔鄉, 974, 1125, 2099, 3999
c13, 嘉義縣, 大林鎮, 6763, 6675, 13438, 26922
c13, 嘉義縣, 太保市, 8074, 8157, 16231, 31568
c13, 嘉義縣, 布袋鎮, 5637, 5557, 11194, 23965
c13, 嘉義縣, 新港鄉, 8171, 6024, 14195, 27342
c13, 嘉義縣, 朴子市, 8989, 8484, 17473, 35191
c13, 嘉義縣, 東石鄉, 4475, 3938, 8413, 21915
c13, 嘉義縣, 梅山鄉, 4342, 4380, 8722, 17083
c13, 嘉義縣, 民雄鄉, 16033, 15073, 31106, 61209
c13, 嘉義縣, 水上鄉, 11291, 10944, 22235, 43857
c13, 嘉義縣, 溪口鄉, 3716, 2754, 6470, 13105
c13, 嘉義縣, 番路鄉, 2438, 2903, 5341, 10156
c13, 嘉義縣, 竹崎鄉, 7748, 7724, 15472, 31228
c13, 嘉義縣, 義竹鄉, 4412, 3735, 8147, 16647
c13, 嘉義縣, 阿里山鄉, 668, 1415, 2083, 4691
c13, 嘉義縣, 鹿草鄉, 3491, 2765, 6256, 13937
c13, 基隆市, , 68736, 90381, 159117, 320030
c13, 基隆市, 七堵區, 10557, 12865, 23422, 46256
c13, 基隆市, 中山區, 9114, 11334, 20448, 41856
c13, 基隆市, 中正區, 8903, 11755, 20658, 45545
c13, 基隆市, 仁愛區, 8790, 10057, 18847, 36738
c13, 基隆市, 信義區, 9344, 14048, 23392, 46014
c13, 基隆市, 安樂區, 14810, 20552, 35362, 70396
c13, 基隆市, 暖暖區, 7218, 9770, 16988, 33225
c13, 宜蘭縣, , 102924, 101242, 204166, 386089
c13, 宜蘭縣, 三星鄉, 5141, 4384, 9525, 19051
c13, 宜蘭縣, 五結鄉, 9229, 8750, 17979, 34892
c13, 宜蘭縣, 冬山鄉, 12475, 11161, 23636, 45405
c13, 宜蘭縣, 南澳鄉, 672, 1924, 2596, 4644
c13, 宜蘭縣, 員山鄉, 7425, 6801, 14226, 28131
c13, 宜蘭縣, 壯圍鄉, 6448, 5286, 11734, 21447
c13, 宜蘭縣, 大同鄉, 829, 1487, 2316, 4935
c13, 宜蘭縣, 宜蘭市, 20491, 22551, 43042, 79167
c13, 宜蘭縣, 礁溪鄉, 8420, 7666, 16086, 31084
c13, 宜蘭縣, 羅東鎮, 15860, 15867, 31727, 57686
c13, 宜蘭縣, 蘇澳鎮, 9632, 8737, 18369, 34512
c13, 宜蘭縣, 頭城鎮, 6302, 6628, 12930, 25135
c13, 屏東縣, , 180402, 177106, 357508, 711720
c13, 屏東縣, 三地門鄉, 1159, 2072, 3231, 6373
c13, 屏東縣, 九如鄉, 5803, 4169, 9972, 19132
c13, 屏東縣, 佳冬鄉, 4645, 3506, 8151, 17063
c13, 屏東縣, 來義鄉, 901, 2490, 3391, 6257
c13, 屏東縣, 內埔鄉, 11532, 10690, 22222, 47558
c13, 屏東縣, 南州鄉, 2691, 2109, 4800, 9479
c13, 屏東縣, 屏東市, 40920, 47103, 88023, 170148
c13, 屏東縣, 崁頂鄉, 3400, 2820, 6220, 12270
c13, 屏東縣, 恆春鎮, 5658, 5977, 11635, 25661
c13, 屏東縣, 新園鄉, 8686, 6597, 15283, 30706
c13, 屏東縣, 新埤鄉, 2345, 2017, 4362, 9033
c13, 屏東縣, 春日鄉, 438, 739, 1177, 3923
c13, 屏東縣, 東港鎮, 10734, 9353, 20087, 39495
c13, 屏東縣, 枋寮鄉, 5601, 5322, 10923, 21394
c13, 屏東縣, 枋山鄉, 1336, 1123, 2459, 4856
c13, 屏東縣, 林邊鄉, 4800, 3582, 8382, 15691
c13, 屏東縣, 泰武鄉, 821, 1705, 2526, 4344
c13, 屏東縣, 滿州鄉, 1516, 1526, 3042, 7206
c13, 屏東縣, 潮州鎮, 11749, 11734, 23483, 46444
c13, 屏東縣, 牡丹鄉, 624, 1091, 1715, 4314
c13, 屏東縣, 獅子鄉, 558, 1421, 1979, 4230
c13, 屏東縣, 琉球鄉, 2007, 2413, 4420, 10706
c13, 屏東縣, 瑪家鄉, 1118, 2186, 3304, 5663
c13, 屏東縣, 竹田鄉, 4570, 3875, 8445, 15353
c13, 屏東縣, 萬丹鄉, 11585, 10424, 22009, 43478
c13, 屏東縣, 萬巒鄉, 5053, 3867, 8920, 17945
c13, 屏東縣, 車城鄉, 1726, 1389, 3115, 7595
c13, 屏東縣, 里港鄉, 6451, 5210, 11661, 22128
c13, 屏東縣, 長治鄉, 6734, 6835, 13569, 26256
c13, 屏東縣, 霧臺鄉, 477, 1108, 1585, 2950
c13, 屏東縣, 高樹鄉, 6107, 4502, 10609, 21697
c13, 屏東縣, 鹽埔鄉, 5568, 5464, 11032, 22402
c13, 屏東縣, 麟洛鄉, 3089, 2687, 5776, 9970
c13, 彰化縣, , 263529, 320975, 584504, 1066994
c13, 彰化縣, 二林鎮, 9219, 12239, 21458, 42976
c13, 彰化縣, 二水鄉, 3741, 3952, 7693, 13339
c13, 彰化縣, 伸港鄉, 7149, 9123, 16272, 30407
c13, 彰化縣, 北斗鎮, 6964, 8461, 15425, 27593
c13, 彰化縣, 和美鎮, 17982, 23021, 41003, 75286
c13, 彰化縣, 員林市, 24024, 31703, 55727, 102028
c13, 彰化縣, 埔心鄉, 7892, 9368, 17260, 29642
c13, 彰化縣, 埔鹽鄉, 6447, 9403, 15850, 28026
c13, 彰化縣, 埤頭鄉, 5962, 7295, 13257, 25677
c13, 彰化縣, 大城鄉, 2427, 2958, 5385, 14713
c13, 彰化縣, 大村鄉, 7869, 9844, 17713, 31492
c13, 彰化縣, 彰化市, 49902, 60848, 110750, 190995
c13, 彰化縣, 永靖鄉, 8051, 9655, 17706, 31239
c13, 彰化縣, 溪州鄉, 6310, 6266, 12576, 25405
c13, 彰化縣, 溪湖鎮, 10763, 14344, 25107, 45147
c13, 彰化縣, 田中鎮, 8539, 10801, 19340, 35391
c13, 彰化縣, 田尾鄉, 5934, 7252, 13186, 23179
c13, 彰化縣, 社頭鄉, 9417, 10689, 20106, 36306
c13, 彰化縣, 福興鄉, 10101, 10335, 20436, 39745
c13, 彰化縣, 秀水鄉, 8386, 10036, 18422, 32394
c13, 彰化縣, 竹塘鄉, 3075, 3532, 6607, 12821
c13, 彰化縣, 線西鄉, 3468, 4493, 7961, 14065
c13, 彰化縣, 芬園鄉, 4761, 5964, 10725, 20408
c13, 彰化縣, 花壇鄉, 9653, 12116, 21769, 38924
c13, 彰化縣, 芳苑鄉, 6731, 6926, 13657, 29291
c13, 彰化縣, 鹿港鎮, 18762, 20351, 39113, 70505
c13, 新北市, , 807514, 985763, 1793277, 3375513
c13, 新北市, 三峽區, 21638, 26238, 47876, 94291
c13, 新北市, 三芝區, 4301, 5036, 9337, 20119
c13, 新北市, 三重區, 89027, 87000, 176027, 329846
c13, 新北市, 中和區, 78167, 112782, 190949, 355978
c13, 新北市, 五股區, 18149, 18856, 37005, 72443
c13, 新北市, 八里區, 7582, 9078, 16660, 32970
c13, 新北市, 土城區, 48850, 56610, 105460, 200783
c13, 新北市, 坪林區, 1546, 1354, 2900, 5891
c13, 新北市, 平溪區, 1025, 955, 1980, 4321
c13, 新北市, 新店區, 53250, 91275, 144525, 264053
c13, 新北市, 新莊區, 90070, 98684, 188754, 344981
c13, 新北市, 板橋區, 119330, 132183, 251513, 463411
c13, 新北市, 林口區, 19747, 26923, 46670, 86203
c13, 新北市, 樹林區, 38133, 42649, 80782, 152102
c13, 新北市, 永和區, 40769, 66263, 107032, 187798
c13, 新北市, 汐止區, 37770, 50984, 88754, 173831
c13, 新北市, 泰山區, 15601, 18739, 34340, 64252
c13, 新北市, 淡水區, 31732, 43633, 75365, 147272
c13, 新北市, 深坑區, 4965, 6014, 10979, 20624
c13, 新北市, 烏來區, 1161, 1575, 2736, 5264
c13, 新北市, 瑞芳區, 7444, 8779, 16223, 35036
c13, 新北市, 石碇區, 1705, 1647, 3352, 6861
c13, 新北市, 石門區, 2352, 2829, 5181, 10528
c13, 新北市, 萬里區, 4214, 4872, 9086, 19297
c13, 新北市, 蘆洲區, 42796, 42780, 85576, 167457
c13, 新北市, 貢寮區, 2671, 2216, 4887, 11279
c13, 新北市, 金山區, 4298, 4686, 8984, 18978
c13, 新北市, 雙溪區, 1751, 1942, 3693, 7999
c13, 新北市, 鶯歌區, 17470, 19181, 36651, 71645
c13, 新竹市, , 80567, 111788, 192355, 351775
c13, 新竹市, 北區, 28399, 38393, 66792, 123122
c13, 新竹市, 東區, 36854, 53513, 90367, 163757
c13, 新竹市, 香山區, 15314, 19882, 35196, 64896
c13, 新竹縣, , 89171, 151859, 241030, 445051
c13, 新竹縣, 五峰鄉, 634, 1208, 1842, 3997
c13, 新竹縣, 北埔鄉, 1630, 2800, 4430, 8180
c13, 新竹縣, 寶山鄉, 2789, 4489, 7278, 12973
c13, 新竹縣, 尖石鄉, 1322, 2023, 3345, 7364
c13, 新竹縣, 峨眉鄉, 1108, 1764, 2872, 5068
c13, 新竹縣, 新埔鎮, 5618, 9947, 15565, 28894
c13, 新竹縣, 新豐鄉, 9188, 15404, 24592, 45790
c13, 新竹縣, 橫山鄉, 2181, 4120, 6301, 11346
c13, 新竹縣, 湖口鄉, 12177, 22044, 34221, 63511
c13, 新竹縣, 竹北市, 30388, 46425, 76813, 137129
c13, 新竹縣, 竹東鎮, 13976, 26778, 40754, 78794
c13, 新竹縣, 芎林鄉, 3394, 6271, 9665, 17293
c13, 新竹縣, 關西鎮, 4766, 8586, 13352, 24712
c13, 桃園市, , 372182, 524453, 896635, 1801823
c13, 桃園市, 中壢區, 65661, 104366, 170027, 334402
c13, 桃園市, 八德區, 33762, 46266, 80028, 165065
c13, 桃園市, 大園區, 16658, 19025, 35683, 73900
c13, 桃園市, 大溪區, 17905, 21660, 39565, 78285
c13, 桃園市, 平鎮區, 36737, 57455, 94192, 183560
c13, 桃園市, 復興區, 1806, 3097, 4903, 9766
c13, 桃園市, 新屋區, 9811, 12325, 22136, 41461
c13, 桃園市, 桃園區, 76752, 100610, 177362, 359790
c13, 桃園市, 楊梅區, 25154, 42561, 67715, 137917
c13, 桃園市, 蘆竹區, 28046, 35267, 63313, 129252
c13, 桃園市, 觀音區, 12464, 14403, 26867, 55149
c13, 桃園市, 龍潭區, 19021, 33219, 52240, 101574
c13, 桃園市, 龜山區, 28405, 34199, 62604, 131702
c13, 澎湖縣, , 16396, 23036, 39432, 90405
c13, 澎湖縣, 七美鄉, 437, 522, 959, 3374
c13, 澎湖縣, 望安鄉, 838, 934, 1772, 4628
c13, 澎湖縣, 湖西鄉, 2445, 3017, 5462, 12741
c13, 澎湖縣, 白沙鄉, 1526, 1997, 3523, 8625
c13, 澎湖縣, 西嶼鄉, 1206, 1232, 2438, 7382
c13, 澎湖縣, 馬公市, 9944, 15334, 25278, 53655
c13, 臺中市, , 554566, 726864, 1281430, 2295642
c13, 臺中市, 中區, 3924, 4112, 8036, 14696
c13, 臺中市, 北區, 29447, 39060, 68507, 124621
c13, 臺中市, 北屯區, 52336, 74638, 126974, 227720
c13, 臺中市, 南區, 27658, 33699, 61357, 103643
c13, 臺中市, 南屯區, 33372, 45708, 79080, 135448
c13, 臺中市, 后里區, 10863, 14165, 25028, 44962
c13, 臺中市, 和平區, 2060, 3598, 5658, 9498
c13, 臺中市, 外埔區, 6256, 8799, 15055, 27059
c13, 臺中市, 大安區, 4122, 5051, 9173, 16520
c13, 臺中市, 大甲區, 15257, 19469, 34726, 63069
c13, 臺中市, 大肚區, 11483, 14998, 26481, 47457
c13, 臺中市, 大里區, 41337, 51702, 93039, 171769
c13, 臺中市, 大雅區, 17763, 24830, 42593, 77189
c13, 臺中市, 太平區, 35443, 47614, 83057, 157926
c13, 臺中市, 新社區, 4811, 6058, 10869, 20860
c13, 臺中市, 東勢區, 9348, 14659, 24007, 43181
c13, 臺中市, 東區, 16941, 19589, 36530, 64291
c13, 臺中市, 梧棲區, 11670, 14094, 25764, 47040
c13, 臺中市, 沙鹿區, 17498, 23018, 40516, 74207
c13, 臺中市, 清水區, 17895, 22161, 40056, 71528
c13, 臺中市, 潭子區, 21605, 28122, 49727, 89487
c13, 臺中市, 烏日區, 15313, 19254, 34567, 61705
c13, 臺中市, 石岡區, 3080, 4148, 7228, 12880
c13, 臺中市, 神岡區, 14344, 16724, 31068, 54565
c13, 臺中市, 西區, 24080, 30113, 54193, 95040
c13, 臺中市, 西屯區, 42283, 60892, 103175, 183814
c13, 臺中市, 豐原區, 35654, 43291, 78945, 136658
c13, 臺中市, 霧峰區, 13869, 17722, 31591, 55225
c13, 臺中市, 龍井區, 14854, 19576, 34430, 63584
c13, 臺北市, , 549973, 701711, 1251684, 2228430
c13, 臺北市, 中山區, 50424, 57828, 108252, 195148
c13, 臺北市, 中正區, 31050, 41827, 72877, 128292
c13, 臺北市, 信義區, 45488, 61995, 107483, 190444
c13, 臺北市, 內湖區, 57038, 77667, 134705, 236824
c13, 臺北市, 北投區, 53284, 63271, 116555, 213250
c13, 臺北市, 南港區, 25347, 32271, 57618, 101907
c13, 臺北市, 士林區, 63841, 70300, 134141, 241854
c13, 臺北市, 大同區, 31712, 29039, 60751, 107557
c13, 臺北市, 大安區, 58256, 83873, 142129, 252645
c13, 臺北市, 文山區, 50746, 80777, 131523, 227211
c13, 臺北市, 松山區, 40881, 56482, 97363, 169278
c13, 臺北市, 萬華區, 41906, 46381, 88287, 164020
c13, 臺南市, , 420409, 376916, 797325, 1594821
c13, 臺南市, 七股區, 5398, 3748, 9146, 19950
c13, 臺南市, 下營區, 5732, 3964, 9696, 20947
c13, 臺南市, 中西區, 19112, 16001, 35113, 65261
c13, 臺南市, 仁德區, 16551, 16740, 33291, 64632
c13, 臺南市, 佳里區, 14077, 11615, 25692, 50407
c13, 臺南市, 六甲區, 5182, 3886, 9068, 19144
c13, 臺南市, 北區, 29375, 28648, 58023, 110906
c13, 臺南市, 北門區, 2304, 1803, 4107, 9925
c13, 臺南市, 南化區, 1690, 1811, 3501, 7786
c13, 臺南市, 南區, 29421, 25046, 54467, 108650
c13, 臺南市, 善化區, 10715, 8929, 19644, 39950
c13, 臺南市, 大內區, 2317, 1737, 4054, 8654
c13, 臺南市, 學甲區, 6136, 4365, 10501, 22567
c13, 臺南市, 安南區, 43287, 37148, 80435, 159654
c13, 臺南市, 安定區, 7400, 5895, 13295, 26104
c13, 臺南市, 安平區, 13735, 13614, 27349, 55379
c13, 臺南市, 官田區, 5375, 3614, 8989, 18675
c13, 臺南市, 將軍區, 4851, 3218, 8069, 17754
c13, 臺南市, 山上區, 1588, 1170, 2758, 6511
c13, 臺南市, 左鎮區, 1051, 820, 1871, 4418
c13, 臺南市, 後壁區, 5630, 3985, 9615, 20841
c13, 臺南市, 新化區, 9846, 9131, 18977, 37296
c13, 臺南市, 新市區, 8670, 7063, 15733, 30386
c13, 臺南市, 新營區, 15671, 16160, 31831, 64949
c13, 臺南市, 東區, 39193, 42054, 81247, 153359
c13, 臺南市, 東山區, 3823, 3010, 6833, 18471
c13, 臺南市, 柳營區, 4986, 3974, 8960, 18804
c13, 臺南市, 楠西區, 1650, 2029, 3679, 8528
c13, 臺南市, 歸仁區, 15705, 13920, 29625, 57387
c13, 臺南市, 永康區, 48369, 50117, 98486, 195001
c13, 臺南市, 玉井區, 2695, 3045, 5740, 12357
c13, 臺南市, 白河區, 6281, 4451, 10732, 24894
c13, 臺南市, 西港區, 5737, 4361, 10098, 21564
c13, 臺南市, 關廟區, 8288, 7200, 15488, 29913
c13, 臺南市, 鹽水區, 6084, 4506, 10590, 22121
c13, 臺南市, 麻豆區, 11585, 7284, 18869, 37963
c13, 臺南市, 龍崎區, 899, 854, 1753, 3713
c13, 臺東縣, , 33959, 55792, 89751, 185996
c13, 臺東縣, 卑南鄉, 3064, 4252, 7316, 14976
c13, 臺東縣, 大武鄉, 915, 1442, 2357, 5266
c13, 臺東縣, 太麻里鄉, 1819, 2565, 4384, 9666
c13, 臺東縣, 延平鄉, 462, 977, 1439, 2930
c13, 臺東縣, 成功鎮, 1958, 3637, 5595, 12426
c13, 臺東縣, 東河鄉, 1212, 1835, 3047, 7635
c13, 臺東縣, 池上鄉, 1293, 1841, 3134, 7162
c13, 臺東縣, 海端鄉, 523, 1084, 1607, 3278
c13, 臺東縣, 綠島鄉, 520, 1005, 1525, 3579
c13, 臺東縣, 臺東市, 16986, 28706, 45692, 87803
c13, 臺東縣, 蘭嶼鄉, 645, 859, 1504, 4181
c13, 臺東縣, 達仁鄉, 512, 1133, 1645, 3137
c13, 臺東縣, 金峰鄉, 473, 1125, 1598, 3028
c13, 臺東縣, 長濱鄉, 927, 1458, 2385, 6484
c13, 臺東縣, 關山鎮, 1337, 2230, 3567, 7509
c13, 臺東縣, 鹿野鄉, 1313, 1643, 2956, 6936
c13, 花蓮縣, , 49349, 88466, 137815, 278059
c13, 花蓮縣, 光復鄉, 1921, 3428, 5349, 11417
c13, 花蓮縣, 卓溪鄉, 792, 1745, 2537, 4947
c13, 花蓮縣, 吉安鄉, 12483, 23812, 36295, 72116
c13, 花蓮縣, 壽豐鄉, 3200, 4894, 8094, 15847
c13, 花蓮縣, 富里鄉, 1492, 2331, 3823, 9065
c13, 花蓮縣, 新城鄉, 3203, 5586, 8789, 17029
c13, 花蓮縣, 玉里鎮, 3227, 5640, 8867, 20650
c13, 花蓮縣, 瑞穗鄉, 1706, 3005, 4711, 10279
c13, 花蓮縣, 秀林鄉, 2351, 3600, 5951, 12562
c13, 花蓮縣, 花蓮市, 15490, 28503, 43993, 84807
c13, 花蓮縣, 萬榮鄉, 1000, 1684, 2684, 5269
c13, 花蓮縣, 豐濱鄉, 678, 1046, 1724, 4395
c13, 花蓮縣, 鳳林鎮, 1806, 3192, 4998, 9676
c13, 苗栗縣, , 97041, 152791, 249832, 461580
c13, 苗栗縣, 三灣鄉, 1147, 2026, 3173, 5852
c13, 苗栗縣, 三義鄉, 2653, 5168, 7821, 13889
c13, 苗栗縣, 公館鄉, 5861, 9817, 15678, 28318
c13, 苗栗縣, 卓蘭鎮, 3658, 4765, 8423, 14772
c13, 苗栗縣, 南庄鄉, 1507, 2539, 4046, 8784
c13, 苗栗縣, 大湖鄉, 2284, 4100, 6384, 12653
c13, 苗栗縣, 後龍鎮, 7316, 8765, 16081, 30948
c13, 苗栗縣, 泰安鄉, 1078, 2158, 3236, 5180
c13, 苗栗縣, 獅潭鄉, 675, 1240, 1915, 3968
c13, 苗栗縣, 竹南鎮, 15174, 21684, 36858, 68528
c13, 苗栗縣, 苑裡鎮, 10084, 11096, 21180, 38890
c13, 苗栗縣, 苗栗市, 13675, 27546, 41221, 74249
c13, 苗栗縣, 西湖鄉, 1213, 2121, 3334, 6382
c13, 苗栗縣, 通霄鎮, 6886, 8240, 15126, 29709
c13, 苗栗縣, 造橋鄉, 2281, 3679, 5960, 11027
c13, 苗栗縣, 銅鑼鄉, 2919, 5279, 8198, 15424
c13, 苗栗縣, 頭份市, 16346, 29011, 45357, 83617
c13, 苗栗縣, 頭屋鄉, 2284, 3557, 5841, 9390
c13, 連江縣, , 1176, 4390, 5566, 11205
c13, 連江縣, 北竿鄉, 215, 853, 1068, 2125
c13, 連江縣, 南竿鄉, 658, 2524, 3182, 6461
c13, 連江縣, 東引鄉, 122, 431, 553, 1138
c13, 連江縣, 莒光鄉, 181, 582, 763, 1481
c13, 金門縣, , 9644, 32014, 41658, 122695
c13, 金門縣, 烈嶼鄉, 790, 3255, 4045, 11676
c13, 金門縣, 烏坵鄉, 43, 115, 158, 567
c13, 金門縣, 金城鎮, 2880, 9719, 12599, 37815
c13, 金門縣, 金寧鄉, 2506, 7185, 9691, 28162
c13, 金門縣, 金沙鎮, 1336, 4889, 6225, 18560
c13, 金門縣, 金湖鎮, 2089, 6851, 8940, 25915
c13, 雲林縣, , 139350, 150404, 289754, 584480
c13, 雲林縣, 二崙鄉, 6007, 4882, 10889, 23367
c13, 雲林縣, 元長鄉, 4961, 4519, 9480, 22830
c13, 雲林縣, 北港鎮, 8945, 8645, 17590, 33958
c13, 雲林縣, 口湖鄉, 5904, 4971, 10875, 24193
c13, 雲林縣, 古坑鄉, 6473, 7378, 13851, 27477
c13, 雲林縣, 四湖鄉, 4104, 3832, 7936, 20983
c13, 雲林縣, 土庫鎮, 5972, 6117, 12089, 24412
c13, 雲林縣, 大埤鄉, 4160, 4038, 8198, 16509
c13, 雲林縣, 崙背鄉, 4948, 4833, 9781, 21050
c13, 雲林縣, 斗六市, 21383, 28507, 49890, 89761
c13, 雲林縣, 斗南鎮, 9624, 11149, 20773, 38138
c13, 雲林縣, 東勢鄉, 3163, 3039, 6202, 13239
c13, 雲林縣, 林內鄉, 3758, 4413, 8171, 15551
c13, 雲林縣, 水林鄉, 5439, 4099, 9538, 22508
c13, 雲林縣, 臺西鄉, 4206, 4886, 9092, 21125
c13, 雲林縣, 莿桐鄉, 6611, 6226, 12837, 24570
c13, 雲林縣, 虎尾鎮, 13438, 16721, 30159, 58167
c13, 雲林縣, 褒忠鄉, 2827, 2858, 5685, 11381
c13, 雲林縣, 西螺鎮, 9923, 9723, 19646, 38142
c13, 雲林縣, 麥寮鄉, 7504, 9568, 17072, 37119
c13, 高雄市, , 658515, 695878, 1354393, 2353342
c13, 高雄市, 三民區, 84073, 84839, 168912, 289519
c13, 高雄市, 仁武區, 21146, 21092, 42238, 73611
c13, 高雄市, 內門區, 3104, 2956, 6060, 13002
c13, 高雄市, 六龜區, 2314, 2752, 5066, 11501
c13, 高雄市, 前金區, 7305, 7122, 14427, 23928
c13, 高雄市, 前鎮區, 45971, 46826, 92797, 161797
c13, 高雄市, 大寮區, 27099, 26851, 53950, 97309
c13, 高雄市, 大樹區, 10872, 9517, 20389, 36772
c13, 高雄市, 大社區, 8762, 7966, 16728, 30046
c13, 高雄市, 小港區, 37792, 38427, 76219, 132733
c13, 高雄市, 岡山區, 22483, 26291, 48774, 81244
c13, 高雄市, 左營區, 41066, 55024, 96090, 161367
c13, 高雄市, 彌陀區, 4807, 4929, 9736, 16487
c13, 高雄市, 新興區, 13820, 13072, 26892, 44355
c13, 高雄市, 旗山區, 9062, 8518, 17580, 31996
c13, 高雄市, 旗津區, 7375, 5403, 12778, 24860
c13, 高雄市, 杉林區, 2294, 2488, 4782, 10607
c13, 高雄市, 林園區, 16857, 15245, 32102, 59129
c13, 高雄市, 桃源區, 548, 1289, 1837, 3498
c13, 高雄市, 梓官區, 9243, 8514, 17757, 31025
c13, 高雄市, 楠梓區, 41039, 47325, 88364, 153132
c13, 高雄市, 橋頭區, 10943, 8929, 19872, 32565
c13, 高雄市, 永安區, 3574, 3744, 7318, 12001
c13, 高雄市, 湖內區, 7333, 6741, 14074, 25729
c13, 高雄市, 燕巢區, 7213, 7164, 14377, 26012
c13, 高雄市, 田寮區, 1838, 1344, 3182, 6671
c13, 高雄市, 甲仙區, 1133, 1390, 2523, 5417
c13, 高雄市, 美濃區, 7983, 10596, 18579, 35311
c13, 高雄市, 苓雅區, 43358, 45565, 88923, 146786
c13, 高雄市, 茂林區, 337, 738, 1075, 1615
c13, 高雄市, 茄萣區, 7266, 6458, 13724, 26212
c13, 高雄市, 路竹區, 12332, 12501, 24833, 43850
c13, 高雄市, 那瑪夏區, 495, 932, 1427, 2424
c13, 高雄市, 阿蓮區, 6635, 6419, 13054, 24534
c13, 高雄市, 鳥松區, 11883, 11317, 23200, 39191
c13, 高雄市, 鳳山區, 80679, 93732, 174411, 300510
c13, 高雄市, 鹽埕區, 7028, 5717, 12745, 21617
c13, 高雄市, 鼓山區, 31453, 36145, 67598, 114979
c14, 全國, , 3382286, 6949697, 10331983, 19757067
c14, 南投縣, , 64424, 169616, 234040, 427089
c14, 南投縣, 中寮鄉, 1881, 5238, 7119, 13181
c14, 南投縣, 仁愛鄉, 1833, 4971, 6804, 12589
c14, 南投縣, 信義鄉, 1752, 5884, 7636, 13299
c14, 南投縣, 南投市, 13599, 35060, 48659, 84328
c14, 南投縣, 名間鄉, 5059, 13700, 18759, 33408
c14, 南投縣, 國姓鄉, 2278, 6513, 8791, 16597
c14, 南投縣, 埔里鎮, 9897, 27617, 37514, 68763
c14, 南投縣, 水里鄉, 2209, 5887, 8096, 15458
c14, 南投縣, 竹山鎮, 6548, 17847, 24395, 47034
c14, 南投縣, 草屯鎮, 13144, 32838, 45982, 82922
c14, 南投縣, 集集鎮, 1468, 3726, 5194, 9611
c14, 南投縣, 魚池鄉, 2215, 4904, 7119, 13958
c14, 南投縣, 鹿谷鄉, 2541, 5431, 7972, 15941
c14, 嘉義市, , 37776, 77841, 115617, 221553
c14, 嘉義市, 東區, 17757, 34768, 52525, 100647
c14, 嘉義市, 西區, 20019, 43073, 63092, 120906
c14, 嘉義縣, , 61462, 144616, 206078, 442775
c14, 嘉義縣, 中埔鄉, 5013, 11948, 16961, 39139
c14, 嘉義縣, 六腳鄉, 2355, 5572, 7927, 20821
c14, 嘉義縣, 大埔鄉, 612, 1454, 2066, 3999
c14, 嘉義縣, 大林鎮, 3920, 9033, 12953, 26922
c14, 嘉義縣, 太保市, 4847, 10763, 15610, 31568
c14, 嘉義縣, 布袋鎮, 2878, 7679, 10557, 23965
c14, 嘉義縣, 新港鄉, 4181, 9079, 13260, 27342
c14, 嘉義縣, 朴子市, 5003, 11776, 16779, 35191
c14, 嘉義縣, 東石鄉, 2032, 5889, 7921, 21915
c14, 嘉義縣, 梅山鄉, 2473, 6061, 8534, 17083
c14, 嘉義縣, 民雄鄉, 9608, 20757, 30365, 61209
c14, 嘉義縣, 水上鄉, 6509, 14932, 21441, 43857
c14, 嘉義縣, 溪口鄉, 1945, 4013, 5958, 13105
c14, 嘉義縣, 番路鄉, 1364, 3923, 5287, 10156
c14, 嘉義縣, 竹崎鄉, 4207, 10831, 15038, 31228
c14, 嘉義縣, 義竹鄉, 2239, 5294, 7533, 16647
c14, 嘉義縣, 阿里山鄉, 437, 1639, 2076, 4691
c14, 嘉義縣, 鹿草鄉, 1839, 3973, 5812, 13937
c14, 基隆市, , 53224, 103741, 156965, 320030
c14, 基隆市, 七堵區, 7825, 15342, 23167, 46256
c14, 基隆市, 中山區, 6749, 13396, 20145, 41856
c14, 基隆市, 中正區, 6497, 13633, 20130, 45545
c14, 基隆市, 仁愛區, 6151, 12100, 18251, 36738
c14, 基隆市, 信義區, 7688, 15505, 23193, 46014
c14, 基隆市, 安樂區, 12394, 22700, 35094, 70396
c14, 基隆市, 暖暖區, 5920, 11065, 16985, 33225
c14, 宜蘭縣, , 66039, 133819, 199858, 386089
c14, 宜蘭縣, 三星鄉, 2905, 6235, 9140, 19051
c14, 宜蘭縣, 五結鄉, 5805, 11661, 17466, 34892
c14, 宜蘭縣, 冬山鄉, 7599, 15447, 23046, 45405
c14, 宜蘭縣, 南澳鄉, 486, 2151, 2637, 4644
c14, 宜蘭縣, 員山鄉, 4660, 9221, 13881, 28131
c14, 宜蘭縣, 壯圍鄉, 3966, 7329, 11295, 21447
c14, 宜蘭縣, 大同鄉, 556, 2141, 2697, 4935
c14, 宜蘭縣, 宜蘭市, 14241, 28110, 42351, 79167
c14, 宜蘭縣, 礁溪鄉, 5114, 10560, 15674, 31084
c14, 宜蘭縣, 羅東鎮, 10777, 20418, 31195, 57686
c14, 宜蘭縣, 蘇澳鎮, 5786, 11967, 17753, 34512
c14, 宜蘭縣, 頭城鎮, 4144, 8579, 12723, 25135
c14, 屏東縣, , 105349, 238235, 343584, 711720
c14, 屏東縣, 三地門鄉, 938, 2463, 3401, 6373
c14, 屏東縣, 九如鄉, 2870, 6438, 9308, 19132
c14, 屏東縣, 佳冬鄉, 2422, 5049, 7471, 17063
c14, 屏東縣, 來義鄉, 788, 2692, 3480, 6257
c14, 屏東縣, 內埔鄉, 6425, 14587, 21012, 47558
c14, 屏東縣, 南州鄉, 1592, 2968, 4560, 9479
c14, 屏東縣, 屏東市, 26847, 59054, 85901, 170148
c14, 屏東縣, 崁頂鄉, 1904, 3962, 5866, 12270
c14, 屏東縣, 恆春鎮, 3613, 7664, 11277, 25661
c14, 屏東縣, 新園鄉, 4401, 10267, 14668, 30706
c14, 屏東縣, 新埤鄉, 1201, 2953, 4154, 9033
c14, 屏東縣, 春日鄉, 432, 897, 1329, 3923
c14, 屏東縣, 東港鎮, 5699, 13456, 19155, 39495
c14, 屏東縣, 枋寮鄉, 2916, 7210, 10126, 21394
c14, 屏東縣, 枋山鄉, 682, 1568, 2250, 4856
c14, 屏東縣, 林邊鄉, 2351, 5531, 7882, 15691
c14, 屏東縣, 泰武鄉, 631, 1948, 2579, 4344
c14, 屏東縣, 滿州鄉, 887, 1982, 2869, 7206
c14, 屏東縣, 潮州鎮, 6776, 15936, 22712, 46444
c14, 屏東縣, 牡丹鄉, 527, 1196, 1723, 4314
c14, 屏東縣, 獅子鄉, 515, 1674, 2189, 4230
c14, 屏東縣, 琉球鄉, 1062, 3341, 4403, 10706
c14, 屏東縣, 瑪家鄉, 862, 2507, 3369, 5663
c14, 屏東縣, 竹田鄉, 2437, 5438, 7875, 15353
c14, 屏東縣, 萬丹鄉, 6538, 14763, 21301, 43478
c14, 屏東縣, 萬巒鄉, 2591, 5675, 8266, 17945
c14, 屏東縣, 車城鄉, 968, 1913, 2881, 7595
c14, 屏東縣, 里港鄉, 3647, 7278, 10925, 22128
c14, 屏東縣, 長治鄉, 4391, 8870, 13261, 26256
c14, 屏東縣, 霧臺鄉, 414, 1291, 1705, 2950
c14, 屏東縣, 高樹鄉, 3064, 6504, 9568, 21697
c14, 屏東縣, 鹽埔鄉, 3263, 7500, 10763, 22402
c14, 屏東縣, 麟洛鄉, 1695, 3660, 5355, 9970
c14, 彰化縣, , 169785, 406975, 576760, 1066994
c14, 彰化縣, 二林鎮, 5654, 15454, 21108, 42976
c14, 彰化縣, 二水鄉, 2210, 5233, 7443, 13339
c14, 彰化縣, 伸港鄉, 4690, 11464, 16154, 30407
c14, 彰化縣, 北斗鎮, 4468, 10677, 15145, 27593
c14, 彰化縣, 和美鎮, 12440, 28280, 40720, 75286
c14, 彰化縣, 員林市, 16826, 38432, 55258, 102028
c14, 彰化縣, 埔心鄉, 4971, 12155, 17126, 29642
c14, 彰化縣, 埔鹽鄉, 3951, 11787, 15738, 28026
c14, 彰化縣, 埤頭鄉, 3697, 9130, 12827, 25677
c14, 彰化縣, 大城鄉, 1268, 3990, 5258, 14713
c14, 彰化縣, 大村鄉, 4826, 12656, 17482, 31492
c14, 彰化縣, 彰化市, 35013, 74892, 109905, 190995
c14, 彰化縣, 永靖鄉, 5312, 12160, 17472, 31239
c14, 彰化縣, 溪州鄉, 3786, 8329, 12115, 25405
c14, 彰化縣, 溪湖鎮, 7098, 17714, 24812, 45147
c14, 彰化縣, 田中鎮, 5233, 13929, 19162, 35391
c14, 彰化縣, 田尾鄉, 3604, 9306, 12910, 23179
c14, 彰化縣, 社頭鄉, 5559, 14208, 19767, 36306
c14, 彰化縣, 福興鄉, 5670, 14443, 20113, 39745
c14, 彰化縣, 秀水鄉, 5339, 12780, 18119, 32394
c14, 彰化縣, 竹塘鄉, 1708, 4713, 6421, 12821
c14, 彰化縣, 線西鄉, 2540, 5284, 7824, 14065
c14, 彰化縣, 芬園鄉, 3275, 7341, 10616, 20408
c14, 彰化縣, 花壇鄉, 6356, 15329, 21685, 38924
c14, 彰化縣, 芳苑鄉, 3302, 9846, 13148, 29291
c14, 彰化縣, 鹿港鎮, 10989, 27443, 38432, 70505
c14, 新北市, , 616312, 1148290, 1764602, 3375513
c14, 新北市, 三峽區, 15839, 31579, 47418, 94291
c14, 新北市, 三芝區, 3073, 6026, 9099, 20119
c14, 新北市, 三重區, 62307, 109279, 171586, 329846
c14, 新北市, 中和區, 63839, 124418, 188257, 355978
c14, 新北市, 五股區, 12563, 24051, 36614, 72443
c14, 新北市, 八里區, 5618, 10819, 16437, 32970
c14, 新北市, 土城區, 36847, 67566, 104413, 200783
c14, 新北市, 坪林區, 828, 1904, 2732, 5891
c14, 新北市, 平溪區, 523, 1348, 1871, 4321
c14, 新北市, 新店區, 47379, 95746, 143125, 264053
c14, 新北市, 新莊區, 66304, 118755, 185059, 344981
c14, 新北市, 板橋區, 88512, 158751, 247263, 463411
c14, 新北市, 林口區, 16387, 29678, 46065, 86203
c14, 新北市, 樹林區, 27613, 52060, 79673, 152102
c14, 新北市, 永和區, 36235, 69918, 106153, 187798
c14, 新北市, 汐止區, 31677, 55598, 87275, 173831
c14, 新北市, 泰山區, 11483, 22314, 33797, 64252
c14, 新北市, 淡水區, 26961, 47281, 74242, 147272
c14, 新北市, 深坑區, 3779, 6991, 10770, 20624
c14, 新北市, 烏來區, 810, 1938, 2748, 5264
c14, 新北市, 瑞芳區, 4937, 10761, 15698, 35036
c14, 新北市, 石碇區, 1015, 2155, 3170, 6861
c14, 新北市, 石門區, 1535, 3352, 4887, 10528
c14, 新北市, 萬里區, 2471, 6352, 8823, 19297
c14, 新北市, 蘆洲區, 30458, 54275, 84733, 167457
c14, 新北市, 貢寮區, 1379, 3133, 4512, 11279
c14, 新北市, 金山區, 2654, 5944, 8598, 18978
c14, 新北市, 雙溪區, 1051, 2456, 3507, 7999
c14, 新北市, 鶯歌區, 12235, 23842, 36077, 71645
c14, 新竹市, , 65851, 124511, 190362, 351775
c14, 新竹市, 北區, 22029, 43977, 66006, 123122
c14, 新竹市, 東區, 32694, 57138, 89832, 163757
c14, 新竹市, 香山區, 11128, 23396, 34524, 64896
c14, 新竹縣, , 73718, 166893, 240611, 445051
c14, 新竹縣, 五峰鄉, 393, 1513, 1906, 3997
c14, 新竹縣, 北埔鄉, 1229, 3165, 4394, 8180
c14, 新竹縣, 寶山鄉, 2262, 4960, 7222, 12973
c14, 新竹縣, 尖石鄉, 681, 2889, 3570, 7364
c14, 新竹縣, 峨眉鄉, 689, 2114, 2803, 5068
c14, 新竹縣, 新埔鎮, 4323, 11109, 15432, 28894
c14, 新竹縣, 新豐鄉, 7092, 17354, 24446, 45790
c14, 新竹縣, 橫山鄉, 1624, 4608, 6232, 11346
c14, 新竹縣, 湖口鄉, 9767, 24243, 34010, 63511
c14, 新竹縣, 竹北市, 27093, 49966, 77059, 137129
c14, 新竹縣, 竹東鎮, 12175, 28462, 40637, 78794
c14, 新竹縣, 芎林鄉, 2767, 6855, 9622, 17293
c14, 新竹縣, 關西鎮, 3623, 9655, 13278, 24712
c14, 桃園市, , 282142, 603494, 885636, 1801823
c14, 桃園市, 中壢區, 53274, 115313, 168587, 334402
c14, 桃園市, 八德區, 25238, 53665, 78903, 165065
c14, 桃園市, 大園區, 11241, 23944, 35185, 73900
c14, 桃園市, 大溪區, 11844, 26711, 38555, 78285
c14, 桃園市, 平鎮區, 29045, 64386, 93431, 183560
c14, 桃園市, 復興區, 967, 4060, 5027, 9766
c14, 桃園市, 新屋區, 6086, 15647, 21733, 41461
c14, 桃園市, 桃園區, 60327, 114427, 174754, 359790
c14, 桃園市, 楊梅區, 19418, 47700, 67118, 137917
c14, 桃園市, 蘆竹區, 20705, 41836, 62541, 129252
c14, 桃園市, 觀音區, 8076, 18134, 26210, 55149
c14, 桃園市, 龍潭區, 14882, 36956, 51838, 101574
c14, 桃園市, 龜山區, 21039, 40715, 61754, 131702
c14, 澎湖縣, , 11008, 27052, 38060, 90405
c14, 澎湖縣, 七美鄉, 317, 625, 942, 3374
c14, 澎湖縣, 望安鄉, 495, 1193, 1688, 4628
c14, 澎湖縣, 湖西鄉, 1445, 3701, 5146, 12741
c14, 澎湖縣, 白沙鄉, 886, 2483, 3369, 8625
c14, 澎湖縣, 西嶼鄉, 666, 1618, 2284, 7382
c14, 澎湖縣, 馬公市, 7199, 17432, 24631, 53655
c14, 臺中市, , 395557, 866827, 1262384, 2295642
c14, 臺中市, 中區, 2451, 5329, 7780, 14696
c14, 臺中市, 北區, 22588, 44811, 67399, 124621
c14, 臺中市, 北屯區, 40045, 85010, 125055, 227720
c14, 臺中市, 南區, 20611, 39862, 60473, 103643
c14, 臺中市, 南屯區, 26220, 52042, 78262, 135448
c14, 臺中市, 后里區, 7155, 17267, 24422, 44962
c14, 臺中市, 和平區, 1190, 4486, 5676, 9498
c14, 臺中市, 外埔區, 3965, 10906, 14871, 27059
c14, 臺中市, 大安區, 2478, 6446, 8924, 16520
c14, 臺中市, 大甲區, 10111, 23943, 34054, 63069
c14, 臺中市, 大肚區, 7711, 18322, 26033, 47457
c14, 臺中市, 大里區, 28448, 63477, 91925, 171769
c14, 臺中市, 大雅區, 12308, 29879, 42187, 77189
c14, 臺中市, 太平區, 24875, 57165, 82040, 157926
c14, 臺中市, 新社區, 2779, 7819, 10598, 20860
c14, 臺中市, 東勢區, 6038, 17546, 23584, 43181
c14, 臺中市, 東區, 11817, 24192, 36009, 64291
c14, 臺中市, 梧棲區, 7603, 17622, 25225, 47040
c14, 臺中市, 沙鹿區, 12165, 27773, 39938, 74207
c14, 臺中市, 清水區, 12030, 27156, 39186, 71528
c14, 臺中市, 潭子區, 15517, 33540, 49057, 89487
c14, 臺中市, 烏日區, 10429, 23671, 34100, 61705
c14, 臺中市, 石岡區, 1890, 5229, 7119, 12880
c14, 臺中市, 神岡區, 8920, 21601, 30521, 54565
c14, 臺中市, 西區, 18475, 34789, 53264, 95040
c14, 臺中市, 西屯區, 34071, 67645, 101716, 183814
c14, 臺中市, 豐原區, 23853, 53873, 77726, 136658
c14, 臺中市, 霧峰區, 8969, 22232, 31201, 55225
c14, 臺中市, 龍井區, 10845, 23194, 34039, 63584
c14, 臺北市, , 469793, 762277, 1232070, 2228430
c14, 臺北市, 中山區, 41628, 64606, 106234, 195148
c14, 臺北市, 中正區, 26803, 45286, 72089, 128292
c14, 臺北市, 信義區, 39545, 66509, 106054, 190444
c14, 臺北市, 內湖區, 52075, 81158, 133233, 236824
c14, 臺北市, 北投區, 43826, 70478, 114304, 213250
c14, 臺北市, 南港區, 21854, 35073, 56927, 101907
c14, 臺北市, 士林區, 50658, 80462, 131120, 241854
c14, 臺北市, 大同區, 23597, 35491, 59088, 107557
c14, 臺北市, 大安區, 53370, 87228, 140598, 252645
c14, 臺北市, 文山區, 47668, 82459, 130127, 227211
c14, 臺北市, 松山區, 36698, 59358, 96056, 169278
c14, 臺北市, 萬華區, 32071, 54169, 86240, 164020
c14, 臺南市, , 257730, 515188, 772918, 1594821
c14, 臺南市, 七股區, 2603, 5898, 8501, 19950
c14, 臺南市, 下營區, 2968, 6079, 9047, 20947
c14, 臺南市, 中西區, 12063, 22317, 34380, 65261
c14, 臺南市, 仁德區, 10442, 22130, 32572, 64632
c14, 臺南市, 佳里區, 7962, 16801, 24763, 50407
c14, 臺南市, 六甲區, 2846, 5630, 8476, 19144
c14, 臺南市, 北區, 19963, 37147, 57110, 110906
c14, 臺南市, 北門區, 1237, 2600, 3837, 9925
c14, 臺南市, 南化區, 974, 2417, 3391, 7786
c14, 臺南市, 南區, 17491, 35260, 52751, 108650
c14, 臺南市, 善化區, 6753, 12468, 19221, 39950
c14, 臺南市, 大內區, 1076, 2658, 3734, 8654
c14, 臺南市, 學甲區, 3070, 6899, 9969, 22567
c14, 臺南市, 安南區, 26267, 52189, 78456, 159654
c14, 臺南市, 安定區, 4048, 8901, 12949, 26104
c14, 臺南市, 安平區, 9422, 17626, 27048, 55379
c14, 臺南市, 官田區, 3074, 5324, 8398, 18675
c14, 臺南市, 將軍區, 2193, 5225, 7418, 17754
c14, 臺南市, 山上區, 852, 1766, 2618, 6511
c14, 臺南市, 左鎮區, 447, 1308, 1755, 4418
c14, 臺南市, 後壁區, 2733, 5938, 8671, 20841
c14, 臺南市, 新化區, 5988, 12714, 18702, 37296
c14, 臺南市, 新市區, 4981, 10371, 15352, 30386
c14, 臺南市, 新營區, 10002, 20659, 30661, 64949
c14, 臺南市, 東區, 27901, 52576, 80477, 153359
c14, 臺南市, 東山區, 1904, 4405, 6309, 18471
c14, 臺南市, 柳營區, 2607, 5834, 8441, 18804
c14, 臺南市, 楠西區, 892, 2621, 3513, 8528
c14, 臺南市, 歸仁區, 9985, 18947, 28932, 57387
c14, 臺南市, 永康區, 32872, 63632, 96504, 195001
c14, 臺南市, 玉井區, 1543, 4001, 5544, 12357
c14, 臺南市, 白河區, 3182, 6671, 9853, 24894
c14, 臺南市, 西港區, 3094, 6473, 9567, 21564
c14, 臺南市, 關廟區, 4616, 10284, 14900, 29913
c14, 臺南市, 鹽水區, 3142, 6633, 9775, 22121
c14, 臺南市, 麻豆區, 6054, 11606, 17660, 37963
c14, 臺南市, 龍崎區, 483, 1180, 1663, 3713
c14, 臺東縣, , 23365, 65685, 89050, 185996
c14, 臺東縣, 卑南鄉, 1956, 5204, 7160, 14976
c14, 臺東縣, 大武鄉, 621, 1713, 2334, 5266
c14, 臺東縣, 太麻里鄉, 1099, 3268, 4367, 9666
c14, 臺東縣, 延平鄉, 352, 1135, 1487, 2930
c14, 臺東縣, 成功鎮, 1189, 4309, 5498, 12426
c14, 臺東縣, 東河鄉, 788, 2203, 2991, 7635
c14, 臺東縣, 池上鄉, 818, 2187, 3005, 7162
c14, 臺東縣, 海端鄉, 351, 1281, 1632, 3278
c14, 臺東縣, 綠島鄉, 481, 1040, 1521, 3579
c14, 臺東縣, 臺東市, 12117, 33290, 45407, 87803
c14, 臺東縣, 蘭嶼鄉, 417, 1093, 1510, 4181
c14, 臺東縣, 達仁鄉, 373, 1312, 1685, 3137
c14, 臺東縣, 金峰鄉, 453, 1217, 1670, 3028
c14, 臺東縣, 長濱鄉, 562, 1793, 2355, 6484
c14, 臺東縣, 關山鎮, 924, 2596, 3520, 7509
c14, 臺東縣, 鹿野鄉, 864, 2044, 2908, 6936
c14, 花蓮縣, , 36102, 100144, 136246, 278059
c14, 花蓮縣, 光復鄉, 1246, 3966, 5212, 11417
c14, 花蓮縣, 卓溪鄉, 551, 2007, 2558, 4947
c14, 花蓮縣, 吉安鄉, 9393, 26662, 36055, 72116
c14, 花蓮縣, 壽豐鄉, 2161, 5885, 8046, 15847
c14, 花蓮縣, 富里鄉, 913, 2810, 3723, 9065
c14, 花蓮縣, 新城鄉, 2336, 6293, 8629, 17029
c14, 花蓮縣, 玉里鎮, 2279, 6432, 8711, 20650
c14, 花蓮縣, 瑞穗鄉, 1029, 3532, 4561, 10279
c14, 花蓮縣, 秀林鄉, 1602, 4402, 6004, 12562
c14, 花蓮縣, 花蓮市, 12198, 31255, 43453, 84807
c14, 花蓮縣, 萬榮鄉, 667, 2014, 2681, 5269
c14, 花蓮縣, 豐濱鄉, 485, 1248, 1733, 4395
c14, 花蓮縣, 鳳林鎮, 1242, 3638, 4880, 9676
c14, 苗栗縣, , 69712, 177248, 246960, 461580
c14, 苗栗縣, 三灣鄉, 800, 2345, 3145, 5852
c14, 苗栗縣, 三義鄉, 1971, 5796, 7767, 13889
c14, 苗栗縣, 公館鄉, 4235, 11312, 15547, 28318
c14, 苗栗縣, 卓蘭鎮, 2247, 5873, 8120, 14772
c14, 苗栗縣, 南庄鄉, 1088, 2956, 4044, 8784
c14, 苗栗縣, 大湖鄉, 1679, 4573, 6252, 12653
c14, 苗栗縣, 後龍鎮, 4624, 11173, 15797, 30948
c14, 苗栗縣, 泰安鄉, 727, 2542, 3269, 5180
c14, 苗栗縣, 獅潭鄉, 436, 1421, 1857, 3968
c14, 苗栗縣, 竹南鎮, 11195, 25219, 36414, 68528
c14, 苗栗縣, 苑裡鎮, 5758, 15032, 20790, 38890
c14, 苗栗縣, 苗栗市, 11499, 29449, 40948, 74249
c14, 苗栗縣, 西湖鄉, 927, 2377, 3304, 6382
c14, 苗栗縣, 通霄鎮, 4317, 10427, 14744, 29709
c14, 苗栗縣, 造橋鄉, 1613, 4303, 5916, 11027
c14, 苗栗縣, 銅鑼鄉, 2188, 5976, 8164, 15424
c14, 苗栗縣, 頭份市, 12822, 32287, 45109, 83617
c14, 苗栗縣, 頭屋鄉, 1586, 4187, 5773, 9390
c14, 連江縣, , 1493, 4083, 5576, 11205
c14, 連江縣, 北竿鄉, 247, 829, 1076, 2125
c14, 連江縣, 南竿鄉, 790, 2397, 3187, 6461
c14, 連江縣, 東引鄉, 271, 285, 556, 1138
c14, 連江縣, 莒光鄉, 185, 572, 757, 1481
c14, 金門縣, , 10414, 31439, 41853, 122695
c14, 金門縣, 烈嶼鄉, 823, 3243, 4066, 11676
c14, 金門縣, 烏坵鄉, 37, 124, 161, 567
c14, 金門縣, 金城鎮, 3216, 9370, 12586, 37815
c14, 金門縣, 金寧鄉, 3026, 6725, 9751, 28162
c14, 金門縣, 金沙鎮, 1191, 5049, 6240, 18560
c14, 金門縣, 金湖鎮, 2121, 6928, 9049, 25915
c14, 雲林縣, , 83844, 196025, 279869, 584480
c14, 雲林縣, 二崙鄉, 3016, 7007, 10023, 23367
c14, 雲林縣, 元長鄉, 2580, 6422, 9002, 22830
c14, 雲林縣, 北港鎮, 5355, 11642, 16997, 33958
c14, 雲林縣, 口湖鄉, 2889, 7343, 10232, 24193
c14, 雲林縣, 古坑鄉, 3823, 9653, 13476, 27477
c14, 雲林縣, 四湖鄉, 2046, 5442, 7488, 20983
c14, 雲林縣, 土庫鎮, 3521, 8220, 11741, 24412
c14, 雲林縣, 大埤鄉, 2326, 5471, 7797, 16509
c14, 雲林縣, 崙背鄉, 2900, 6510, 9410, 21050
c14, 雲林縣, 斗六市, 14769, 34352, 49121, 89761
c14, 雲林縣, 斗南鎮, 6245, 14041, 20286, 38138
c14, 雲林縣, 東勢鄉, 1805, 4192, 5997, 13239
c14, 雲林縣, 林內鄉, 2451, 5524, 7975, 15551
c14, 雲林縣, 水林鄉, 2789, 6007, 8796, 22508
c14, 雲林縣, 臺西鄉, 2308, 6511, 8819, 21125
c14, 雲林縣, 莿桐鄉, 3806, 8512, 12318, 24570
c14, 雲林縣, 虎尾鎮, 8894, 20574, 29468, 58167
c14, 雲林縣, 褒忠鄉, 1690, 3767, 5457, 11381
c14, 雲林縣, 西螺鎮, 5739, 12903, 18642, 38142
c14, 雲林縣, 麥寮鄉, 4892, 11932, 16824, 37119
c14, 高雄市, , 427186, 885698, 1312884, 2353342
c14, 高雄市, 三民區, 56428, 107656, 164084, 289519
c14, 高雄市, 仁武區, 13145, 28120, 41265, 73611
c14, 高雄市, 內門區, 1561, 4042, 5603, 13002
c14, 高雄市, 六龜區, 1414, 3476, 4890, 11501
c14, 高雄市, 前金區, 4649, 9216, 13865, 23928
c14, 高雄市, 前鎮區, 29186, 60498, 89684, 161797
c14, 高雄市, 大寮區, 16625, 35779, 52404, 97309
c14, 高雄市, 大樹區, 5867, 13398, 19265, 36772
c14, 高雄市, 大社區, 5495, 10662, 16157, 30046
c14, 高雄市, 小港區, 24368, 49715, 74083, 132733
c14, 高雄市, 岡山區, 14572, 32998, 47570, 81244
c14, 高雄市, 左營區, 29870, 64229, 94099, 161367
c14, 高雄市, 彌陀區, 3231, 6147, 9378, 16487
c14, 高雄市, 新興區, 9020, 16882, 25902, 44355
c14, 高雄市, 旗山區, 5161, 11400, 16561, 31996
c14, 高雄市, 旗津區, 3934, 8078, 12012, 24860
c14, 高雄市, 杉林區, 1180, 3386, 4566, 10607
c14, 高雄市, 林園區, 9748, 21186, 30934, 59129
c14, 高雄市, 桃源區, 395, 1376, 1771, 3498
c14, 高雄市, 梓官區, 5333, 11730, 17063, 31025
c14, 高雄市, 楠梓區, 28203, 58257, 86460, 153132
c14, 高雄市, 橋頭區, 6068, 12780, 18848, 32565
c14, 高雄市, 永安區, 2115, 4960, 7075, 12001
c14, 高雄市, 湖內區, 4290, 9315, 13605, 25729
c14, 高雄市, 燕巢區, 4238, 9634, 13872, 26012
c14, 高雄市, 田寮區, 903, 2007, 2910, 6671
c14, 高雄市, 甲仙區, 681, 1759, 2440, 5417
c14, 高雄市, 美濃區, 4763, 13154, 17917, 35311
c14, 高雄市, 苓雅區, 28522, 57208, 85730, 146786
c14, 高雄市, 茂林區, 233, 837, 1070, 1615
c14, 高雄市, 茄萣區, 4092, 9081, 13173, 26212
c14, 高雄市, 路竹區, 7707, 16540, 24247, 43850
c14, 高雄市, 那瑪夏區, 285, 1201, 1486, 2424
c14, 高雄市, 阿蓮區, 3946, 8606, 12552, 24534
c14, 高雄市, 鳥松區, 7872, 14815, 22687, 39191
c14, 高雄市, 鳳山區, 55389, 114830, 170219, 300510
c14, 高雄市, 鹽埕區, 4601, 7454, 12055, 21617
c14, 高雄市, 鼓山區, 22096, 43286, 65382, 114979
c15, 全國, , 3507665, 6805171, 10312836, 19757067
c15, 南投縣, , 68393, 165077, 233470, 427089
c15, 南投縣, 中寮鄉, 1943, 5131, 7074, 13181
c15, 南投縣, 仁愛鄉, 1695, 5070, 6765, 12589
c15, 南投縣, 信義鄉, 1461, 6133, 7594, 13299
c15, 南投縣, 南投市, 14491, 34230, 48721, 84328
c15, 南投縣, 名間鄉, 5405, 13160, 18565, 33408
c15, 南投縣, 國姓鄉, 2268, 6510, 8778, 16597
c15, 南投縣, 埔里鎮, 10904, 26454, 37358, 68763
c15, 南投縣, 水里鄉, 2326, 5784, 8110, 15458
c15, 南投縣, 竹山鎮, 7543, 16737, 24280, 47034
c15, 南投縣, 草屯鎮, 14396, 31506, 45902, 82922
c15, 南投縣, 集集鎮, 1562, 3642, 5204, 9611
c15, 南投縣, 魚池鄉, 2123, 4942, 7065, 13958
c15, 南投縣, 鹿谷鄉, 2276, 5778, 8054, 15941
c15, 嘉義市, , 39449, 75746, 115195, 221553
c15, 嘉義市, 東區, 18474, 33619, 52093, 100647
c15, 嘉義市, 西區, 20975, 42127, 63102, 120906
c15, 嘉義縣, , 65100, 139182, 204282, 442775
c15, 嘉義縣, 中埔鄉, 5328, 11537, 16865, 39139
c15, 嘉義縣, 六腳鄉, 2568, 5282, 7850, 20821
c15, 嘉義縣, 大埔鄉, 634, 1397, 2031, 3999
c15, 嘉義縣, 大林鎮, 4191, 8594, 12785, 26922
c15, 嘉義縣, 太保市, 5217, 10385, 15602, 31568
c15, 嘉義縣, 布袋鎮, 3048, 7395, 10443, 23965
c15, 嘉義縣, 新港鄉, 4330, 8597, 12927, 27342
c15, 嘉義縣, 朴子市, 5426, 11329, 16755, 35191
c15, 嘉義縣, 東石鄉, 2179, 5707, 7886, 21915
c15, 嘉義縣, 梅山鄉, 2612, 5888, 8500, 17083
c15, 嘉義縣, 民雄鄉, 10079, 19984, 30063, 61209
c15, 嘉義縣, 水上鄉, 6712, 14609, 21321, 43857
c15, 嘉義縣, 溪口鄉, 2024, 3870, 5894, 13105
c15, 嘉義縣, 番路鄉, 1436, 3778, 5214, 10156
c15, 嘉義縣, 竹崎鄉, 4432, 10473, 14905, 31228
c15, 嘉義縣, 義竹鄉, 2458, 5021, 7479, 16647
c15, 嘉義縣, 阿里山鄉, 430, 1610, 2040, 4691
c15, 嘉義縣, 鹿草鄉, 1996, 3726, 5722, 13937
c15, 基隆市, , 54369, 102268, 156637, 320030
c15, 基隆市, 七堵區, 8017, 15107, 23124, 46256
c15, 基隆市, 中山區, 6929, 13362, 20291, 41856
c15, 基隆市, 中正區, 6983, 13181, 20164, 45545
c15, 基隆市, 仁愛區, 6390, 11793, 18183, 36738
c15, 基隆市, 信義區, 7869, 15251, 23120, 46014
c15, 基隆市, 安樂區, 12312, 22626, 34938, 70396
c15, 基隆市, 暖暖區, 5869, 10948, 16817, 33225
c15, 宜蘭縣, , 69188, 130483, 199671, 386089
c15, 宜蘭縣, 三星鄉, 3118, 6076, 9194, 19051
c15, 宜蘭縣, 五結鄉, 6188, 11329, 17517, 34892
c15, 宜蘭縣, 冬山鄉, 8099, 14995, 23094, 45405
c15, 宜蘭縣, 南澳鄉, 538, 2088, 2626, 4644
c15, 宜蘭縣, 員山鄉, 4651, 9182, 13833, 28131
c15, 宜蘭縣, 壯圍鄉, 3935, 7302, 11237, 21447
c15, 宜蘭縣, 大同鄉, 528, 2137, 2665, 4935
c15, 宜蘭縣, 宜蘭市, 14997, 27404, 42401, 79167
c15, 宜蘭縣, 礁溪鄉, 5360, 10197, 15557, 31084
c15, 宜蘭縣, 羅東鎮, 11312, 19797, 31109, 57686
c15, 宜蘭縣, 蘇澳鎮, 6130, 11634, 17764, 34512
c15, 宜蘭縣, 頭城鎮, 4332, 8342, 12674, 25135
c15, 屏東縣, , 113331, 229686, 343017, 711720
c15, 屏東縣, 三地門鄉, 985, 2381, 3366, 6373
c15, 屏東縣, 九如鄉, 2950, 6397, 9347, 19132
c15, 屏東縣, 佳冬鄉, 2520, 4918, 7438, 17063
c15, 屏東縣, 來義鄉, 822, 2639, 3461, 6257
c15, 屏東縣, 內埔鄉, 6775, 14248, 21023, 47558
c15, 屏東縣, 南州鄉, 1618, 2921, 4539, 9479
c15, 屏東縣, 屏東市, 29361, 56512, 85873, 170148
c15, 屏東縣, 崁頂鄉, 2014, 3865, 5879, 12270
c15, 屏東縣, 恆春鎮, 3668, 7587, 11255, 25661
c15, 屏東縣, 新園鄉, 4787, 9799, 14586, 30706
c15, 屏東縣, 新埤鄉, 1301, 2812, 4113, 9033
c15, 屏東縣, 春日鄉, 440, 877, 1317, 3923
c15, 屏東縣, 東港鎮, 6062, 13078, 19140, 39495
c15, 屏東縣, 枋寮鄉, 3196, 6773, 9969, 21394
c15, 屏東縣, 枋山鄉, 707, 1563, 2270, 4856
c15, 屏東縣, 林邊鄉, 2763, 5109, 7872, 15691
c15, 屏東縣, 泰武鄉, 699, 1915, 2614, 4344
c15, 屏東縣, 滿州鄉, 971, 1913, 2884, 7206
c15, 屏東縣, 潮州鎮, 7197, 15460, 22657, 46444
c15, 屏東縣, 牡丹鄉, 570, 1137, 1707, 4314
c15, 屏東縣, 獅子鄉, 525, 1655, 2180, 4230
c15, 屏東縣, 琉球鄉, 1041, 3387, 4428, 10706
c15, 屏東縣, 瑪家鄉, 880, 2505, 3385, 5663
c15, 屏東縣, 竹田鄉, 3162, 4856, 8018, 15353
c15, 屏東縣, 萬丹鄉, 7211, 14001, 21212, 43478
c15, 屏東縣, 萬巒鄉, 2813, 5417, 8230, 17945
c15, 屏東縣, 車城鄉, 1020, 1844, 2864, 7595
c15, 屏東縣, 里港鄉, 3616, 7226, 10842, 22128
c15, 屏東縣, 長治鄉, 4527, 8662, 13189, 26256
c15, 屏東縣, 霧臺鄉, 433, 1268, 1701, 2950
c15, 屏東縣, 高樹鄉, 3246, 6296, 9542, 21697
c15, 屏東縣, 鹽埔鄉, 3430, 7284, 10714, 22402
c15, 屏東縣, 麟洛鄉, 2021, 3381, 5402, 9970
c15, 彰化縣, , 177421, 398192, 575613, 1066994
c15, 彰化縣, 二林鎮, 6416, 14593, 21009, 42976
c15, 彰化縣, 二水鄉, 2152, 5295, 7447, 13339
c15, 彰化縣, 伸港鄉, 4958, 11141, 16099, 30407
c15, 彰化縣, 北斗鎮, 4843, 10218, 15061, 27593
c15, 彰化縣, 和美鎮, 12951, 27751, 40702, 75286
c15, 彰化縣, 員林市, 17321, 38055, 55376, 102028
c15, 彰化縣, 埔心鄉, 5282, 11827, 17109, 29642
c15, 彰化縣, 埔鹽鄉, 4272, 11478, 15750, 28026
c15, 彰化縣, 埤頭鄉, 3871, 8865, 12736, 25677
c15, 彰化縣, 大城鄉, 1381, 3849, 5230, 14713
c15, 彰化縣, 大村鄉, 5500, 11990, 17490, 31492
c15, 彰化縣, 彰化市, 35239, 74545, 109784, 190995
c15, 彰化縣, 永靖鄉, 5651, 11781, 17432, 31239
c15, 彰化縣, 溪州鄉, 3775, 8280, 12055, 25405
c15, 彰化縣, 溪湖鎮, 7695, 17023, 24718, 45147
c15, 彰化縣, 田中鎮, 5778, 13245, 19023, 35391
c15, 彰化縣, 田尾鄉, 3867, 8997, 12864, 23179
c15, 彰化縣, 社頭鄉, 5908, 13849, 19757, 36306
c15, 彰化縣, 福興鄉, 6368, 13715, 20083, 39745
c15, 彰化縣, 秀水鄉, 5578, 12461, 18039, 32394
c15, 彰化縣, 竹塘鄉, 1832, 4539, 6371, 12821
c15, 彰化縣, 線西鄉, 2323, 5545, 7868, 14065
c15, 彰化縣, 芬園鄉, 3045, 7442, 10487, 20408
c15, 彰化縣, 花壇鄉, 6224, 15562, 21786, 38924
c15, 彰化縣, 芳苑鄉, 3674, 9277, 12951, 29291
c15, 彰化縣, 鹿港鎮, 11517, 26869, 38386, 70505
c15, 新北市, , 631350, 1127654, 1759004, 3375513
c15, 新北市, 三峽區, 16312, 30727, 47039, 94291
c15, 新北市, 三芝區, 3186, 5837, 9023, 20119
c15, 新北市, 三重區, 64488, 107248, 171736, 329846
c15, 新北市, 中和區, 65604, 122740, 188344, 355978
c15, 新北市, 五股區, 12868, 23458, 36326, 72443
c15, 新北市, 八里區, 5690, 10721, 16411, 32970
c15, 新北市, 土城區, 37665, 66049, 103714, 200783
c15, 新北市, 坪林區, 898, 1829, 2727, 5891
c15, 新北市, 平溪區, 547, 1297, 1844, 4321
c15, 新北市, 新店區, 48345, 93966, 142311, 264053
c15, 新北市, 新莊區, 67789, 117471, 185260, 344981
c15, 新北市, 板橋區, 89876, 156175, 246051, 463411
c15, 新北市, 林口區, 16881, 29035, 45916, 86203
c15, 新北市, 樹林區, 28180, 51144, 79324, 152102
c15, 新北市, 永和區, 37605, 68429, 106034, 187798
c15, 新北市, 汐止區, 32285, 54856, 87141, 173831
c15, 新北市, 泰山區, 11793, 21896, 33689, 64252
c15, 新北市, 淡水區, 26552, 47418, 73970, 147272
c15, 新北市, 深坑區, 3861, 6894, 10755, 20624
c15, 新北市, 烏來區, 832, 1919, 2751, 5264
c15, 新北市, 瑞芳區, 5235, 10465, 15700, 35036
c15, 新北市, 石碇區, 1094, 2082, 3176, 6861
c15, 新北市, 石門區, 1579, 3331, 4910, 10528
c15, 新北市, 萬里區, 2609, 6072, 8681, 19297
c15, 新北市, 蘆洲區, 31191, 52571, 83762, 167457
c15, 新北市, 貢寮區, 1418, 3049, 4467, 11279
c15, 新北市, 金山區, 3271, 5466, 8737, 18978
c15, 新北市, 雙溪區, 1037, 2472, 3509, 7999
c15, 新北市, 鶯歌區, 12659, 23037, 35696, 71645
c15, 新竹市, , 67231, 123030, 190261, 351775
c15, 新竹市, 北區, 22925, 42900, 65825, 123122
c15, 新竹市, 東區, 32753, 57090, 89843, 163757
c15, 新竹市, 香山區, 11553, 23040, 34593, 64896
c15, 新竹縣, , 77180, 163313, 240493, 445051
c15, 新竹縣, 五峰鄉, 387, 1487, 1874, 3997
c15, 新竹縣, 北埔鄉, 1549, 2847, 4396, 8180
c15, 新竹縣, 寶山鄉, 2608, 4591, 7199, 12973
c15, 新竹縣, 尖石鄉, 710, 2826, 3536, 7364
c15, 新竹縣, 峨眉鄉, 742, 2039, 2781, 5068
c15, 新竹縣, 新埔鎮, 4611, 10817, 15428, 28894
c15, 新竹縣, 新豐鄉, 7296, 17099, 24395, 45790
c15, 新竹縣, 橫山鄉, 1742, 4507, 6249, 11346
c15, 新竹縣, 湖口鄉, 10422, 23740, 34162, 63511
c15, 新竹縣, 竹北市, 27936, 49115, 77051, 137129
c15, 新竹縣, 竹東鎮, 12563, 28093, 40656, 78794
c15, 新竹縣, 芎林鄉, 2855, 6702, 9557, 17293
c15, 新竹縣, 關西鎮, 3759, 9450, 13209, 24712
c15, 桃園市, , 295646, 590939, 886585, 1801823
c15, 桃園市, 中壢區, 55628, 113277, 168905, 334402
c15, 桃園市, 八德區, 26246, 52650, 78896, 165065
c15, 桃園市, 大園區, 11444, 23644, 35088, 73900
c15, 桃園市, 大溪區, 12329, 26181, 38510, 78285
c15, 桃園市, 平鎮區, 29969, 63734, 93703, 183560
c15, 桃園市, 復興區, 984, 4041, 5025, 9766
c15, 桃園市, 新屋區, 6408, 15202, 21610, 41461
c15, 桃園市, 桃園區, 63229, 111711, 174940, 359790
c15, 桃園市, 楊梅區, 21210, 46233, 67443, 137917
c15, 桃園市, 蘆竹區, 21787, 40963, 62750, 129252
c15, 桃園市, 觀音區, 8475, 17670, 26145, 55149
c15, 桃園市, 龍潭區, 15518, 36190, 51708, 101574
c15, 桃園市, 龜山區, 22419, 39443, 61862, 131702
c15, 澎湖縣, , 11489, 26451, 37940, 90405
c15, 澎湖縣, 七美鄉, 326, 614, 940, 3374
c15, 澎湖縣, 望安鄉, 487, 1186, 1673, 4628
c15, 澎湖縣, 湖西鄉, 1473, 3640, 5113, 12741
c15, 澎湖縣, 白沙鄉, 947, 2395, 3342, 8625
c15, 澎湖縣, 西嶼鄉, 684, 1598, 2282, 7382
c15, 澎湖縣, 馬公市, 7572, 17018, 24590, 53655
c15, 臺中市, , 411320, 850532, 1261852, 2295642
c15, 臺中市, 中區, 2487, 5268, 7755, 14696
c15, 臺中市, 北區, 23371, 44261, 67632, 124621
c15, 臺中市, 北屯區, 41689, 83227, 124916, 227720
c15, 臺中市, 南區, 20975, 39392, 60367, 103643
c15, 臺中市, 南屯區, 27215, 51229, 78444, 135448
c15, 臺中市, 后里區, 7622, 16964, 24586, 44962
c15, 臺中市, 和平區, 1280, 4348, 5628, 9498
c15, 臺中市, 外埔區, 4102, 10757, 14859, 27059
c15, 臺中市, 大安區, 2665, 6258, 8923, 16520
c15, 臺中市, 大甲區, 10769, 23336, 34105, 63069
c15, 臺中市, 大肚區, 7860, 18142, 26002, 47457
c15, 臺中市, 大里區, 29508, 62260, 91768, 171769
c15, 臺中市, 大雅區, 13441, 28615, 42056, 77189
c15, 臺中市, 太平區, 25949, 55823, 81772, 157926
c15, 臺中市, 新社區, 2984, 7517, 10501, 20860
c15, 臺中市, 東勢區, 6696, 16783, 23479, 43181
c15, 臺中市, 東區, 11829, 23874, 35703, 64291
c15, 臺中市, 梧棲區, 7915, 17312, 25227, 47040
c15, 臺中市, 沙鹿區, 12711, 27332, 40043, 74207
c15, 臺中市, 清水區, 12574, 26528, 39102, 71528
c15, 臺中市, 潭子區, 15257, 33803, 49060, 89487
c15, 臺中市, 烏日區, 10735, 23059, 33794, 61705
c15, 臺中市, 石岡區, 2109, 4964, 7073, 12880
c15, 臺中市, 神岡區, 9121, 21157, 30278, 54565
c15, 臺中市, 西區, 19150, 34098, 53248, 95040
c15, 臺中市, 西屯區, 35684, 66785, 102469, 183814
c15, 臺中市, 豐原區, 25365, 52434, 77799, 136658
c15, 臺中市, 霧峰區, 9513, 21777, 31290, 55225
c15, 臺中市, 龍井區, 10744, 23229, 33973, 63584
c15, 臺北市, , 479771, 751265, 1231036, 2228430
c15, 臺北市, 中山區, 42578, 64018, 106596, 195148
c15, 臺北市, 中正區, 27634, 44386, 72020, 128292
c15, 臺北市, 信義區, 40135, 65500, 105635, 190444
c15, 臺北市, 內湖區, 52518, 80236, 132754, 236824
c15, 臺北市, 北投區, 44378, 69714, 114092, 213250
c15, 臺北市, 南港區, 22312, 34517, 56829, 101907
c15, 臺北市, 士林區, 51855, 79244, 131099, 241854
c15, 臺北市, 大同區, 24094, 34885, 58979, 107557
c15, 臺北市, 大安區, 54598, 85851, 140449, 252645
c15, 臺北市, 文山區, 49133, 81140, 130273, 227211
c15, 臺北市, 松山區, 37298, 58829, 96127, 169278
c15, 臺北市, 萬華區, 33238, 52945, 86183, 164020
c15, 臺南市, , 270957, 502776, 773733, 1594821
c15, 臺南市, 七股區, 2723, 5757, 8480, 19950
c15, 臺南市, 下營區, 3091, 5832, 8923, 20947
c15, 臺南市, 中西區, 12476, 21937, 34413, 65261
c15, 臺南市, 仁德區, 10819, 21560, 32379, 64632
c15, 臺南市, 佳里區, 8520, 16286, 24806, 50407
c15, 臺南市, 六甲區, 3197, 5234, 8431, 19144
c15, 臺南市, 北區, 20680, 36676, 57356, 110906
c15, 臺南市, 北門區, 1139, 2677, 3816, 9925
c15, 臺南市, 南化區, 1054, 2331, 3385, 7786
c15, 臺南市, 南區, 18076, 34732, 52808, 108650
c15, 臺南市, 善化區, 7092, 12087, 19179, 39950
c15, 臺南市, 大內區, 1171, 2546, 3717, 8654
c15, 臺南市, 學甲區, 3357, 6682, 10039, 22567
c15, 臺南市, 安南區, 27446, 51577, 79023, 159654
c15, 臺南市, 安定區, 4337, 8389, 12726, 26104
c15, 臺南市, 安平區, 9779, 17393, 27172, 55379
c15, 臺南市, 官田區, 3068, 5351, 8419, 18675
c15, 臺南市, 將軍區, 2093, 5114, 7207, 17754
c15, 臺南市, 山上區, 928, 1713, 2641, 6511
c15, 臺南市, 左鎮區, 501, 1245, 1746, 4418
c15, 臺南市, 後壁區, 2975, 5775, 8750, 20841
c15, 臺南市, 新化區, 6530, 12063, 18593, 37296
c15, 臺南市, 新市區, 5374, 9981, 15355, 30386
c15, 臺南市, 新營區, 10841, 20018, 30859, 64949
c15, 臺南市, 東區, 29616, 50890, 80506, 153359
c15, 臺南市, 東山區, 2089, 4204, 6293, 18471
c15, 臺南市, 柳營區, 2872, 5658, 8530, 18804
c15, 臺南市, 楠西區, 995, 2544, 3539, 8528
c15, 臺南市, 歸仁區, 9988, 18728, 28716, 57387
c15, 臺南市, 永康區, 34171, 62863, 97034, 195001
c15, 臺南市, 玉井區, 1665, 3878, 5543, 12357
c15, 臺南市, 白河區, 3476, 6415, 9891, 24894
c15, 臺南市, 西港區, 3256, 6328, 9584, 21564
c15, 臺南市, 關廟區, 4948, 9878, 14826, 29913
c15, 臺南市, 鹽水區, 3508, 6307, 9815, 22121
c15, 臺南市, 麻豆區, 6621, 10960, 17581, 37963
c15, 臺南市, 龍崎區, 485, 1167, 1652, 3713
c15, 臺東縣, , 24813, 62900, 87713, 185996
c15, 臺東縣, 卑南鄉, 2112, 4952, 7064, 14976
c15, 臺東縣, 大武鄉, 636, 1670, 2306, 5266
c15, 臺東縣, 太麻里鄉, 1147, 3148, 4295, 9666
c15, 臺東縣, 延平鄉, 335, 1118, 1453, 2930
c15, 臺東縣, 成功鎮, 1217, 4110, 5327, 12426
c15, 臺東縣, 東河鄉, 831, 2088, 2919, 7635
c15, 臺東縣, 池上鄉, 894, 2075, 2969, 7162
c15, 臺東縣, 海端鄉, 373, 1226, 1599, 3278
c15, 臺東縣, 綠島鄉, 467, 1039, 1506, 3579
c15, 臺東縣, 臺東市, 12992, 31881, 44873, 87803
c15, 臺東縣, 蘭嶼鄉, 452, 1032, 1484, 4181
c15, 臺東縣, 達仁鄉, 382, 1261, 1643, 3137
c15, 臺東縣, 金峰鄉, 454, 1176, 1630, 3028
c15, 臺東縣, 長濱鄉, 593, 1717, 2310, 6484
c15, 臺東縣, 關山鎮, 1032, 2442, 3474, 7509
c15, 臺東縣, 鹿野鄉, 896, 1965, 2861, 6936
c15, 花蓮縣, , 38850, 97972, 136822, 278059
c15, 花蓮縣, 光復鄉, 1345, 3871, 5216, 11417
c15, 花蓮縣, 卓溪鄉, 585, 2002, 2587, 4947
c15, 花蓮縣, 吉安鄉, 10232, 26015, 36247, 72116
c15, 花蓮縣, 壽豐鄉, 2363, 5703, 8066, 15847
c15, 花蓮縣, 富里鄉, 1034, 2693, 3727, 9065
c15, 花蓮縣, 新城鄉, 2473, 6193, 8666, 17029
c15, 花蓮縣, 玉里鎮, 2402, 6382, 8784, 20650
c15, 花蓮縣, 瑞穗鄉, 1135, 3451, 4586, 10279
c15, 花蓮縣, 秀林鄉, 1694, 4326, 6020, 12562
c15, 花蓮縣, 花蓮市, 13072, 30596, 43668, 84807
c15, 花蓮縣, 萬榮鄉, 668, 1986, 2654, 5269
c15, 花蓮縣, 豐濱鄉, 520, 1207, 1727, 4395
c15, 花蓮縣, 鳳林鎮, 1327, 3547, 4874, 9676
c15, 苗栗縣, , 74809, 172173, 246982, 461580
c15, 苗栗縣, 三灣鄉, 855, 2253, 3108, 5852
c15, 苗栗縣, 三義鄉, 2166, 5583, 7749, 13889
c15, 苗栗縣, 公館鄉, 4595, 10963, 15558, 28318
c15, 苗栗縣, 卓蘭鎮, 2341, 5742, 8083, 14772
c15, 苗栗縣, 南庄鄉, 1189, 2880, 4069, 8784
c15, 苗栗縣, 大湖鄉, 1898, 4329, 6227, 12653
c15, 苗栗縣, 後龍鎮, 5002, 10779, 15781, 30948
c15, 苗栗縣, 泰安鄉, 777, 2490, 3267, 5180
c15, 苗栗縣, 獅潭鄉, 497, 1381, 1878, 3968
c15, 苗栗縣, 竹南鎮, 11697, 24847, 36544, 68528
c15, 苗栗縣, 苑裡鎮, 6245, 14548, 20793, 38890
c15, 苗栗縣, 苗栗市, 12854, 28018, 40872, 74249
c15, 苗栗縣, 西湖鄉, 987, 2288, 3275, 6382
c15, 苗栗縣, 通霄鎮, 4556, 10178, 14734, 29709
c15, 苗栗縣, 造橋鄉, 1696, 4224, 5920, 11027
c15, 苗栗縣, 銅鑼鄉, 2346, 5800, 8146, 15424
c15, 苗栗縣, 頭份市, 13417, 31783, 45200, 83617
c15, 苗栗縣, 頭屋鄉, 1691, 4087, 5778, 9390
c15, 連江縣, , 1480, 4110, 5590, 11205
c15, 連江縣, 北竿鄉, 266, 811, 1077, 2125
c15, 連江縣, 南竿鄉, 849, 2342, 3191, 6461
c15, 連江縣, 東引鄉, 165, 397, 562, 1138
c15, 連江縣, 莒光鄉, 200, 560, 760, 1481
c15, 金門縣, , 10826, 30970, 41796, 122695
c15, 金門縣, 烈嶼鄉, 869, 3202, 4071, 11676
c15, 金門縣, 烏坵鄉, 38, 125, 163, 567
c15, 金門縣, 金城鎮, 3241, 9347, 12588, 37815
c15, 金門縣, 金寧鄉, 3170, 6573, 9743, 28162
c15, 金門縣, 金沙鎮, 1258, 4967, 6225, 18560
c15, 金門縣, 金湖鎮, 2250, 6756, 9006, 25915
c15, 雲林縣, , 88127, 190434, 278561, 584480
c15, 雲林縣, 二崙鄉, 3275, 6738, 10013, 23367
c15, 雲林縣, 元長鄉, 2717, 6177, 8894, 22830
c15, 雲林縣, 北港鎮, 5486, 11404, 16890, 33958
c15, 雲林縣, 口湖鄉, 2990, 7195, 10185, 24193
c15, 雲林縣, 古坑鄉, 4164, 9260, 13424, 27477
c15, 雲林縣, 四湖鄉, 2192, 5251, 7443, 20983
c15, 雲林縣, 土庫鎮, 3824, 7891, 11715, 24412
c15, 雲林縣, 大埤鄉, 2538, 5310, 7848, 16509
c15, 雲林縣, 崙背鄉, 2880, 6338, 9218, 21050
c15, 雲林縣, 斗六市, 15497, 33537, 49034, 89761
c15, 雲林縣, 斗南鎮, 6583, 13713, 20296, 38138
c15, 雲林縣, 東勢鄉, 1761, 4200, 5961, 13239
c15, 雲林縣, 林內鄉, 2539, 5386, 7925, 15551
c15, 雲林縣, 水林鄉, 2689, 6034, 8723, 22508
c15, 雲林縣, 臺西鄉, 2524, 6237, 8761, 21125
c15, 雲林縣, 莿桐鄉, 4027, 8252, 12279, 24570
c15, 雲林縣, 虎尾鎮, 9596, 19755, 29351, 58167
c15, 雲林縣, 褒忠鄉, 1790, 3641, 5431, 11381
c15, 雲林縣, 西螺鎮, 6128, 12384, 18512, 38142
c15, 雲林縣, 麥寮鄉, 4927, 11731, 16658, 37119
c15, 高雄市, , 436565, 870018, 1306583, 2353342
c15, 高雄市, 三民區, 56856, 106137, 162993, 289519
c15, 高雄市, 仁武區, 13068, 28094, 41162, 73611
c15, 高雄市, 內門區, 1695, 3965, 5660, 13002
c15, 高雄市, 六龜區, 1451, 3386, 4837, 11501
c15, 高雄市, 前金區, 4776, 8995, 13771, 23928
c15, 高雄市, 前鎮區, 30275, 58765, 89040, 161797
c15, 高雄市, 大寮區, 16588, 35551, 52139, 97309
c15, 高雄市, 大樹區, 6166, 13003, 19169, 36772
c15, 高雄市, 大社區, 5753, 10353, 16106, 30046
c15, 高雄市, 小港區, 25181, 48504, 73685, 132733
c15, 高雄市, 岡山區, 14680, 32567, 47247, 81244
c15, 高雄市, 左營區, 30605, 63666, 94271, 161367
c15, 高雄市, 彌陀區, 2893, 6438, 9331, 16487
c15, 高雄市, 新興區, 9445, 16428, 25873, 44355
c15, 高雄市, 旗山區, 5654, 10819, 16473, 31996
c15, 高雄市, 旗津區, 4223, 7751, 11974, 24860
c15, 高雄市, 杉林區, 1437, 2898, 4335, 10607
c15, 高雄市, 林園區, 10174, 20560, 30734, 59129
c15, 高雄市, 桃源區, 385, 1450, 1835, 3498
c15, 高雄市, 梓官區, 5238, 11624, 16862, 31025
c15, 高雄市, 楠梓區, 28585, 57582, 86167, 153132
c15, 高雄市, 橋頭區, 6321, 12345, 18666, 32565
c15, 高雄市, 永安區, 2323, 4723, 7046, 12001
c15, 高雄市, 湖內區, 4289, 9148, 13437, 25729
c15, 高雄市, 燕巢區, 4398, 9355, 13753, 26012
c15, 高雄市, 田寮區, 897, 1982, 2879, 6671
c15, 高雄市, 甲仙區, 706, 1702, 2408, 5417
c15, 高雄市, 美濃區, 4922, 12858, 17780, 35311
c15, 高雄市, 苓雅區, 29700, 55824, 85524, 146786
c15, 高雄市, 茂林區, 246, 812, 1058, 1615
c15, 高雄市, 茄萣區, 4510, 8546, 13056, 26212
c15, 高雄市, 路竹區, 7908, 16072, 23980, 43850
c15, 高雄市, 那瑪夏區, 283, 1184, 1467, 2424
c15, 高雄市, 阿蓮區, 4353, 8139, 12492, 24534
c15, 高雄市, 鳥松區, 7877, 14661, 22538, 39191
c15, 高雄市, 鳳山區, 55770, 113855, 169625, 300510
c15, 高雄市, 鹽埕區, 4613, 7277, 11890, 21617
c15, 高雄市, 鼓山區, 22321, 42999, 65320, 114979
c16, 全國, , 5895560, 4014215, 9909775, 19757067
c16, 南投縣, , 138860, 85227, 224087, 427089
c16, 南投縣, 中寮鄉, 4091, 2681, 6772, 13181
c16, 南投縣, 仁愛鄉, 3866, 2240, 6106, 12589
c16, 南投縣, 信義鄉, 4054, 2328, 6382, 13299
c16, 南投縣, 南投市, 29595, 17785, 47380, 84328
c16, 南投縣, 名間鄉, 11108, 6888, 17996, 33408
c16, 南投縣, 國姓鄉, 5164, 3258, 8422, 16597
c16, 南投縣, 埔里鎮, 22085, 13740, 35825, 68763
c16, 南投縣, 水里鄉, 4806, 2957, 7763, 15458
c16, 南投縣, 竹山鎮, 14566, 8897, 23463, 47034
c16, 南投縣, 草屯鎮, 27449, 17070, 44519, 82922
c16, 南投縣, 集集鎮, 3091, 1875, 4966, 9611
c16, 南投縣, 魚池鄉, 4192, 2636, 6828, 13958
c16, 南投縣, 鹿谷鄉, 4793, 2872, 7665, 15941
c16, 嘉義市, , 64519, 45975, 110494, 221553
c16, 嘉義市, 東區, 29288, 21014, 50302, 100647
c16, 嘉義市, 西區, 35231, 24961, 60192, 120906
c16, 嘉義縣, , 114627, 81395, 196022, 442775
c16, 嘉義縣, 中埔鄉, 9376, 6797, 16173, 39139
c16, 嘉義縣, 六腳鄉, 4311, 3010, 7321, 20821
c16, 嘉義縣, 大埔鄉, 1165, 789, 1954, 3999
c16, 嘉義縣, 大林鎮, 7123, 5269, 12392, 26922
c16, 嘉義縣, 太保市, 8778, 6106, 14884, 31568
c16, 嘉義縣, 布袋鎮, 6202, 3859, 10061, 23965
c16, 嘉義縣, 新港鄉, 7286, 5235, 12521, 27342
c16, 嘉義縣, 朴子市, 9407, 6717, 16124, 35191
c16, 嘉義縣, 東石鄉, 4402, 2914, 7316, 21915
c16, 嘉義縣, 梅山鄉, 4757, 3413, 8170, 17083
c16, 嘉義縣, 民雄鄉, 16658, 12239, 28897, 61209
c16, 嘉義縣, 水上鄉, 12155, 8383, 20538, 43857
c16, 嘉義縣, 溪口鄉, 3260, 2464, 5724, 13105
c16, 嘉義縣, 番路鄉, 2849, 2154, 5003, 10156
c16, 嘉義縣, 竹崎鄉, 8088, 6112, 14200, 31228
c16, 嘉義縣, 義竹鄉, 4391, 2845, 7236, 16647
c16, 嘉義縣, 阿里山鄉, 1137, 809, 1946, 4691
c16, 嘉義縣, 鹿草鄉, 3282, 2280, 5562, 13937
c16, 基隆市, , 90311, 61447, 151758, 320030
c16, 基隆市, 七堵區, 13203, 9184, 22387, 46256
c16, 基隆市, 中山區, 11495, 8015, 19510, 41856
c16, 基隆市, 中正區, 11413, 8035, 19448, 45545
c16, 基隆市, 仁愛區, 10277, 7453, 17730, 36738
c16, 基隆市, 信義區, 13576, 8744, 22320, 46014
c16, 基隆市, 安樂區, 20635, 13539, 34174, 70396
c16, 基隆市, 暖暖區, 9712, 6477, 16189, 33225
c16, 宜蘭縣, , 111743, 77082, 188825, 386089
c16, 宜蘭縣, 三星鄉, 5091, 3657, 8748, 19051
c16, 宜蘭縣, 五結鄉, 9815, 6809, 16624, 34892
c16, 宜蘭縣, 冬山鄉, 13244, 8821, 22065, 45405
c16, 宜蘭縣, 南澳鄉, 1491, 847, 2338, 4644
c16, 宜蘭縣, 員山鄉, 7442, 5549, 12991, 28131
c16, 宜蘭縣, 壯圍鄉, 6234, 4316, 10550, 21447
c16, 宜蘭縣, 大同鄉, 1222, 807, 2029, 4935
c16, 宜蘭縣, 宜蘭市, 23936, 16264, 40200, 79167
c16, 宜蘭縣, 礁溪鄉, 8806, 6001, 14807, 31084
c16, 宜蘭縣, 羅東鎮, 17459, 12335, 29794, 57686
c16, 宜蘭縣, 蘇澳鎮, 10050, 6665, 16715, 34512
c16, 宜蘭縣, 頭城鎮, 6953, 5011, 11964, 25135
c16, 屏東縣, , 192218, 136052, 328270, 711720
c16, 屏東縣, 三地門鄉, 1712, 1155, 2867, 6373
c16, 屏東縣, 九如鄉, 5096, 3903, 8999, 19132
c16, 屏東縣, 佳冬鄉, 4194, 3005, 7199, 17063
c16, 屏東縣, 來義鄉, 2124, 1037, 3161, 6257
c16, 屏東縣, 內埔鄉, 11406, 8400, 19806, 47558
c16, 屏東縣, 南州鄉, 2503, 1871, 4374, 9479
c16, 屏東縣, 屏東市, 49795, 33508, 83303, 170148
c16, 屏東縣, 崁頂鄉, 3357, 2348, 5705, 12270
c16, 屏東縣, 恆春鎮, 6226, 4698, 10924, 25661
c16, 屏東縣, 新園鄉, 8152, 5749, 13901, 30706
c16, 屏東縣, 新埤鄉, 2253, 1670, 3923, 9033
c16, 屏東縣, 春日鄉, 546, 409, 955, 3923
c16, 屏東縣, 東港鎮, 10468, 7821, 18289, 39495
c16, 屏東縣, 枋寮鄉, 5747, 3997, 9744, 21394
c16, 屏東縣, 枋山鄉, 1283, 869, 2152, 4856
c16, 屏東縣, 林邊鄉, 4367, 3224, 7591, 15691
c16, 屏東縣, 泰武鄉, 1410, 943, 2353, 4344
c16, 屏東縣, 滿州鄉, 1611, 1165, 2776, 7206
c16, 屏東縣, 潮州鎮, 12945, 9090, 22035, 46444
c16, 屏東縣, 牡丹鄉, 957, 667, 1624, 4314
c16, 屏東縣, 獅子鄉, 1027, 676, 1703, 4230
c16, 屏東縣, 琉球鄉, 2507, 1521, 4028, 10706
c16, 屏東縣, 瑪家鄉, 1873, 1134, 3007, 5663
c16, 屏東縣, 竹田鄉, 4466, 3319, 7785, 15353
c16, 屏東縣, 萬丹鄉, 11618, 8736, 20354, 43478
c16, 屏東縣, 萬巒鄉, 4477, 3300, 7777, 17945
c16, 屏東縣, 車城鄉, 1562, 1186, 2748, 7595
c16, 屏東縣, 里港鄉, 5945, 4656, 10601, 22128
c16, 屏東縣, 長治鄉, 7444, 5185, 12629, 26256
c16, 屏東縣, 霧臺鄉, 823, 626, 1449, 2950
c16, 屏東縣, 高樹鄉, 5343, 3843, 9186, 21697
c16, 屏東縣, 鹽埔鄉, 6046, 4102, 10148, 22402
c16, 屏東縣, 麟洛鄉, 2935, 2239, 5174, 9970
c16, 彰化縣, , 328349, 223084, 551433, 1066994
c16, 彰化縣, 二林鎮, 11880, 8187, 20067, 42976
c16, 彰化縣, 二水鄉, 4055, 2953, 7008, 13339
c16, 彰化縣, 伸港鄉, 9449, 6096, 15545, 30407
c16, 彰化縣, 北斗鎮, 8622, 5815, 14437, 27593
c16, 彰化縣, 和美鎮, 23210, 15941, 39151, 75286
c16, 彰化縣, 員林市, 32021, 21152, 53173, 102028
c16, 彰化縣, 埔心鄉, 9909, 6543, 16452, 29642
c16, 彰化縣, 埔鹽鄉, 9245, 5822, 15067, 28026
c16, 彰化縣, 埤頭鄉, 7504, 4793, 12297, 25677
c16, 彰化縣, 大城鄉, 2976, 1899, 4875, 14713
c16, 彰化縣, 大村鄉, 10080, 6700, 16780, 31492
c16, 彰化縣, 彰化市, 61812, 43718, 105530, 190995
c16, 彰化縣, 永靖鄉, 9888, 6806, 16694, 31239
c16, 彰化縣, 溪州鄉, 6641, 4852, 11493, 25405
c16, 彰化縣, 溪湖鎮, 14324, 9370, 23694, 45147
c16, 彰化縣, 田中鎮, 10701, 7580, 18281, 35391
c16, 彰化縣, 田尾鄉, 7479, 4855, 12334, 23179
c16, 彰化縣, 社頭鄉, 11509, 7432, 18941, 36306
c16, 彰化縣, 福興鄉, 11401, 7659, 19060, 39745
c16, 彰化縣, 秀水鄉, 10186, 7197, 17383, 32394
c16, 彰化縣, 竹塘鄉, 3597, 2360, 5957, 12821
c16, 彰化縣, 線西鄉, 4647, 2949, 7596, 14065
c16, 彰化縣, 芬園鄉, 6153, 4024, 10177, 20408
c16, 彰化縣, 花壇鄉, 12086, 8503, 20589, 38924
c16, 彰化縣, 芳苑鄉, 7397, 4898, 12295, 29291
c16, 彰化縣, 鹿港鎮, 21577, 14980, 36557, 70505
c16, 新北市, , 1000493, 691936, 1692429, 3375513
c16, 新北市, 三峽區, 26544, 18649, 45193, 94291
c16, 新北市, 三芝區, 5087, 3686, 8773, 20119
c16, 新北市, 三重區, 93399, 70120, 163519, 329846
c16, 新北市, 中和區, 110005, 70784, 180789, 355978
c16, 新北市, 五股區, 20000, 14792, 34792, 72443
c16, 新北市, 八里區, 9280, 6562, 15842, 32970
c16, 新北市, 土城區, 59061, 40462, 99523, 200783
c16, 新北市, 坪林區, 1535, 1030, 2565, 5891
c16, 新北市, 平溪區, 1034, 710, 1744, 4321
c16, 新北市, 新店區, 86688, 52198, 138886, 264053
c16, 新北市, 新莊區, 103947, 73997, 177944, 344981
c16, 新北市, 板橋區, 136267, 98719, 234986, 463411
c16, 新北市, 林口區, 26917, 18029, 44946, 86203
c16, 新北市, 樹林區, 43905, 32015, 75920, 152102
c16, 新北市, 永和區, 62766, 39572, 102338, 187798
c16, 新北市, 汐止區, 50587, 33825, 84412, 173831
c16, 新北市, 泰山區, 19053, 13363, 32416, 64252
c16, 新北市, 淡水區, 42612, 29215, 71827, 147272
c16, 新北市, 深坑區, 6116, 4199, 10315, 20624
c16, 新北市, 烏來區, 1540, 958, 2498, 5264
c16, 新北市, 瑞芳區, 8893, 6104, 14997, 35036
c16, 新北市, 石碇區, 1680, 1329, 3009, 6861
c16, 新北市, 石門區, 2776, 2005, 4781, 10528
c16, 新北市, 萬里區, 4941, 3578, 8519, 19297
c16, 新北市, 蘆洲區, 46599, 34317, 80916, 167457
c16, 新北市, 貢寮區, 2347, 2384, 4731, 11279
c16, 新北市, 金山區, 4900, 3746, 8646, 18978
c16, 新北市, 雙溪區, 2067, 1357, 3424, 7999
c16, 新北市, 鶯歌區, 19947, 14231, 34178, 71645
c16, 新竹市, , 110083, 73690, 183773, 351775
c16, 新竹市, 北區, 37623, 25982, 63605, 123122
c16, 新竹市, 東區, 52428, 34488, 86916, 163757
c16, 新竹市, 香山區, 20032, 13220, 33252, 64896
c16, 新竹縣, , 139470, 93309, 232779, 445051
c16, 新竹縣, 五峰鄉, 946, 601, 1547, 3997
c16, 新竹縣, 北埔鄉, 2513, 1706, 4219, 8180
c16, 新竹縣, 寶山鄉, 4244, 2763, 7007, 12973
c16, 新竹縣, 尖石鄉, 1697, 1279, 2976, 7364
c16, 新竹縣, 峨眉鄉, 1579, 1102, 2681, 5068
c16, 新竹縣, 新埔鎮, 9280, 5735, 15015, 28894
c16, 新竹縣, 新豐鄉, 14072, 9655, 23727, 45790
c16, 新竹縣, 橫山鄉, 3613, 2444, 6057, 11346
c16, 新竹縣, 湖口鄉, 19891, 13229, 33120, 63511
c16, 新竹縣, 竹北市, 44987, 30205, 75192, 137129
c16, 新竹縣, 竹東鎮, 23823, 15411, 39234, 78794
c16, 新竹縣, 芎林鄉, 5368, 3877, 9245, 17293
c16, 新竹縣, 關西鎮, 7457, 5302, 12759, 24712
c16, 桃園市, , 518318, 337300, 855618, 1801823
c16, 桃園市, 中壢區, 100616, 62949, 163565, 334402
c16, 桃園市, 八德區, 45937, 30421, 76358, 165065
c16, 桃園市, 大園區, 19806, 13867, 33673, 73900
c16, 桃園市, 大溪區, 21913, 15074, 36987, 78285
c16, 桃園市, 平鎮區, 55590, 34675, 90265, 183560
c16, 桃園市, 復興區, 2604, 1932, 4536, 9766
c16, 桃園市, 新屋區, 12387, 8582, 20969, 41461
c16, 桃園市, 桃園區, 101918, 67207, 169125, 359790
c16, 桃園市, 楊梅區, 40318, 24433, 64751, 137917
c16, 桃園市, 蘆竹區, 35742, 24763, 60505, 129252
c16, 桃園市, 觀音區, 14918, 10234, 25152, 55149
c16, 桃園市, 龍潭區, 31654, 18551, 50205, 101574
c16, 桃園市, 龜山區, 34915, 24612, 59527, 131702
c16, 澎湖縣, , 22697, 13207, 35904, 90405
c16, 澎湖縣, 七美鄉, 535, 340, 875, 3374
c16, 澎湖縣, 望安鄉, 945, 573, 1518, 4628
c16, 澎湖縣, 湖西鄉, 3078, 1727, 4805, 12741
c16, 澎湖縣, 白沙鄉, 2003, 1180, 3183, 8625
c16, 澎湖縣, 西嶼鄉, 1266, 768, 2034, 7382
c16, 澎湖縣, 馬公市, 14870, 8619, 23489, 53655
c16, 臺中市, , 725778, 478271, 1204049, 2295642
c16, 臺中市, 中區, 4199, 3157, 7356, 14696
c16, 臺中市, 北區, 38821, 25381, 64202, 124621
c16, 臺中市, 北屯區, 73413, 46183, 119596, 227720
c16, 臺中市, 南區, 34386, 23722, 58108, 103643
c16, 臺中市, 南屯區, 45026, 29930, 74956, 135448
c16, 臺中市, 后里區, 14056, 9112, 23168, 44962
c16, 臺中市, 和平區, 3117, 2061, 5178, 9498
c16, 臺中市, 外埔區, 8609, 5582, 14191, 27059
c16, 臺中市, 大安區, 4964, 3443, 8407, 16520
c16, 臺中市, 大甲區, 19426, 13302, 32728, 63069
c16, 臺中市, 大肚區, 14878, 9711, 24589, 47457
c16, 臺中市, 大里區, 52609, 34361, 86970, 171769
c16, 臺中市, 大雅區, 24116, 15958, 40074, 77189
c16, 臺中市, 太平區, 47742, 30518, 78260, 157926
c16, 臺中市, 新社區, 5903, 3924, 9827, 20860
c16, 臺中市, 東勢區, 13214, 9096, 22310, 43181
c16, 臺中市, 東區, 20239, 13985, 34224, 64291
c16, 臺中市, 梧棲區, 14523, 9551, 24074, 47040
c16, 臺中市, 沙鹿區, 22892, 15188, 38080, 74207
c16, 臺中市, 清水區, 23167, 14645, 37812, 71528
c16, 臺中市, 潭子區, 28569, 18357, 46926, 89487
c16, 臺中市, 烏日區, 19358, 13048, 32406, 61705
c16, 臺中市, 石岡區, 4113, 2674, 6787, 12880
c16, 臺中市, 神岡區, 16779, 12035, 28814, 54565
c16, 臺中市, 西區, 30092, 20956, 51048, 95040
c16, 臺中市, 西屯區, 59399, 38045, 97444, 183814
c16, 臺中市, 豐原區, 45002, 29882, 74884, 136658
c16, 臺中市, 霧峰區, 17744, 11582, 29326, 55225
c16, 臺中市, 龍井區, 19422, 12882, 32304, 63584
c16, 臺北市, , 698579, 494516, 1193095, 2228430
c16, 臺北市, 中山區, 58611, 44414, 103025, 195148
c16, 臺北市, 中正區, 41549, 28544, 70093, 128292
c16, 臺北市, 信義區, 60987, 41507, 102494, 190444
c16, 臺北市, 內湖區, 76531, 52585, 129116, 236824
c16, 臺北市, 北投區, 64303, 46598, 110901, 213250
c16, 臺北市, 南港區, 31894, 23041, 54935, 101907
c16, 臺北市, 士林區, 71992, 54662, 126654, 241854
c16, 臺北市, 大同區, 31347, 25374, 56721, 107557
c16, 臺北市, 大安區, 80894, 55473, 136367, 252645
c16, 臺北市, 文山區, 77470, 49080, 126550, 227211
c16, 臺北市, 松山區, 55200, 38025, 93225, 169278
c16, 臺北市, 萬華區, 47801, 35213, 83014, 164020
c16, 臺南市, , 422398, 310812, 733210, 1594821
c16, 臺南市, 七股區, 4511, 3087, 7598, 19950
c16, 臺南市, 下營區, 5003, 3481, 8484, 20947
c16, 臺南市, 中西區, 17852, 14831, 32683, 65261
c16, 臺南市, 仁德區, 17804, 13064, 30868, 64632
c16, 臺南市, 佳里區, 13974, 9415, 23389, 50407
c16, 臺南市, 六甲區, 4574, 3591, 8165, 19144
c16, 臺南市, 北區, 31092, 23203, 54295, 110906
c16, 臺南市, 北門區, 2089, 1422, 3511, 9925
c16, 臺南市, 南化區, 1883, 1368, 3251, 7786
c16, 臺南市, 南區, 27903, 21566, 49469, 108650
c16, 臺南市, 善化區, 10307, 7882, 18189, 39950
c16, 臺南市, 大內區, 2110, 1454, 3564, 8654
c16, 臺南市, 學甲區, 5511, 4003, 9514, 22567
c16, 臺南市, 安南區, 42902, 32042, 74944, 159654
c16, 臺南市, 安定區, 7000, 5286, 12286, 26104
c16, 臺南市, 安平區, 14746, 10955, 25701, 55379
c16, 臺南市, 官田區, 4618, 3440, 8058, 18675
c16, 臺南市, 將軍區, 3964, 2778, 6742, 17754
c16, 臺南市, 山上區, 1457, 1016, 2473, 6511
c16, 臺南市, 左鎮區, 945, 707, 1652, 4418
c16, 臺南市, 後壁區, 4616, 3468, 8084, 20841
c16, 臺南市, 新化區, 10063, 7660, 17723, 37296
c16, 臺南市, 新市區, 8362, 6149, 14511, 30386
c16, 臺南市, 新營區, 17689, 11710, 29399, 64949
c16, 臺南市, 東區, 44495, 32777, 77272, 153359
c16, 臺南市, 東山區, 3372, 2451, 5823, 18471
c16, 臺南市, 柳營區, 4734, 3219, 7953, 18804
c16, 臺南市, 楠西區, 1991, 1346, 3337, 8528
c16, 臺南市, 歸仁區, 15594, 11711, 27305, 57387
c16, 臺南市, 永康區, 53835, 38433, 92268, 195001
c16, 臺南市, 玉井區, 3185, 2093, 5278, 12357
c16, 臺南市, 白河區, 5294, 3848, 9142, 24894
c16, 臺南市, 西港區, 5130, 3712, 8842, 21564
c16, 臺南市, 關廟區, 8203, 5835, 14038, 29913
c16, 臺南市, 鹽水區, 5279, 3921, 9200, 22121
c16, 臺南市, 麻豆區, 9408, 7250, 16658, 37963
c16, 臺南市, 龍崎區, 903, 638, 1541, 3713
c16, 臺東縣, , 51032, 33932, 84964, 185996
c16, 臺東縣, 卑南鄉, 4065, 2819, 6884, 14976
c16, 臺東縣, 大武鄉, 1216, 902, 2118, 5266
c16, 臺東縣, 太麻里鄉, 2359, 1612, 3971, 9666
c16, 臺東縣, 延平鄉, 736, 598, 1334, 2930
c16, 臺東縣, 成功鎮, 3232, 2001, 5233, 12426
c16, 臺東縣, 東河鄉, 1629, 1177, 2806, 7635
c16, 臺東縣, 池上鄉, 1706, 1169, 2875, 7162
c16, 臺東縣, 海端鄉, 855, 685, 1540, 3278
c16, 臺東縣, 綠島鄉, 902, 553, 1455, 3579
c16, 臺東縣, 臺東市, 27095, 16947, 44042, 87803
c16, 臺東縣, 蘭嶼鄉, 634, 817, 1451, 4181
c16, 臺東縣, 達仁鄉, 752, 805, 1557, 3137
c16, 臺東縣, 金峰鄉, 847, 563, 1410, 3028
c16, 臺東縣, 長濱鄉, 1269, 840, 2109, 6484
c16, 臺東縣, 關山鎮, 2106, 1315, 3421, 7509
c16, 臺東縣, 鹿野鄉, 1629, 1129, 2758, 6936
c16, 花蓮縣, , 80187, 50311, 130498, 278059
c16, 花蓮縣, 光復鄉, 3023, 1911, 4934, 11417
c16, 花蓮縣, 卓溪鄉, 1380, 927, 2307, 4947
c16, 花蓮縣, 吉安鄉, 21528, 13261, 34789, 72116
c16, 花蓮縣, 壽豐鄉, 4465, 3251, 7716, 15847
c16, 花蓮縣, 富里鄉, 2133, 1402, 3535, 9065
c16, 花蓮縣, 新城鄉, 5139, 3191, 8330, 17029
c16, 花蓮縣, 玉里鎮, 5053, 3251, 8304, 20650
c16, 花蓮縣, 瑞穗鄉, 2656, 1672, 4328, 10279
c16, 花蓮縣, 秀林鄉, 3423, 2036, 5459, 12562
c16, 花蓮縣, 花蓮市, 26165, 15949, 42114, 84807
c16, 花蓮縣, 萬榮鄉, 1438, 1013, 2451, 5269
c16, 花蓮縣, 豐濱鄉, 940, 657, 1597, 4395
c16, 花蓮縣, 鳳林鎮, 2844, 1790, 4634, 9676
c16, 苗栗縣, , 143501, 95723, 239224, 461580
c16, 苗栗縣, 三灣鄉, 1768, 1224, 2992, 5852
c16, 苗栗縣, 三義鄉, 4396, 3171, 7567, 13889
c16, 苗栗縣, 公館鄉, 9169, 5871, 15040, 28318
c16, 苗栗縣, 卓蘭鎮, 4776, 3004, 7780, 14772
c16, 苗栗縣, 南庄鄉, 2287, 1614, 3901, 8784
c16, 苗栗縣, 大湖鄉, 3651, 2420, 6071, 12653
c16, 苗栗縣, 後龍鎮, 8788, 6427, 15215, 30948
c16, 苗栗縣, 泰安鄉, 1747, 1319, 3066, 5180
c16, 苗栗縣, 獅潭鄉, 1151, 684, 1835, 3968
c16, 苗栗縣, 竹南鎮, 21072, 14424, 35496, 68528
c16, 苗栗縣, 苑裡鎮, 11583, 8373, 19956, 38890
c16, 苗栗縣, 苗栗市, 25170, 14843, 40013, 74249
c16, 苗栗縣, 西湖鄉, 1889, 1305, 3194, 6382
c16, 苗栗縣, 通霄鎮, 8260, 5890, 14150, 29709
c16, 苗栗縣, 造橋鄉, 3386, 2359, 5745, 11027
c16, 苗栗縣, 銅鑼鄉, 4875, 3100, 7975, 15424
c16, 苗栗縣, 頭份市, 26103, 17535, 43638, 83617
c16, 苗栗縣, 頭屋鄉, 3430, 2160, 5590, 9390
c16, 連江縣, , 3764, 1663, 5427, 11205
c16, 連江縣, 北竿鄉, 707, 336, 1043, 2125
c16, 連江縣, 南竿鄉, 2201, 903, 3104, 6461
c16, 連江縣, 東引鄉, 354, 200, 554, 1138
c16, 連江縣, 莒光鄉, 502, 224, 726, 1481
c16, 金門縣, , 26851, 13274, 40125, 122695
c16, 金門縣, 烈嶼鄉, 2806, 1171, 3977, 11676
c16, 金門縣, 烏坵鄉, 95, 62, 157, 567
c16, 金門縣, 金城鎮, 8057, 3974, 12031, 37815
c16, 金門縣, 金寧鄉, 6132, 3276, 9408, 28162
c16, 金門縣, 金沙鎮, 3999, 1972, 5971, 18560
c16, 金門縣, 金湖鎮, 5762, 2819, 8581, 25915
c16, 雲林縣, , 158850, 106155, 265005, 584480
c16, 雲林縣, 二崙鄉, 5577, 3875, 9452, 23367
c16, 雲林縣, 元長鄉, 4869, 3423, 8292, 22830
c16, 雲林縣, 北港鎮, 9640, 6339, 15979, 33958
c16, 雲林縣, 口湖鄉, 5828, 3728, 9556, 24193
c16, 雲林縣, 古坑鄉, 7747, 4974, 12721, 27477
c16, 雲林縣, 四湖鄉, 4108, 2841, 6949, 20983
c16, 雲林縣, 土庫鎮, 6582, 4488, 11070, 24412
c16, 雲林縣, 大埤鄉, 4411, 3055, 7466, 16509
c16, 雲林縣, 崙背鄉, 5216, 3642, 8858, 21050
c16, 雲林縣, 斗六市, 28906, 18421, 47327, 89761
c16, 雲林縣, 斗南鎮, 11322, 8111, 19433, 38138
c16, 雲林縣, 東勢鄉, 3325, 2250, 5575, 13239
c16, 雲林縣, 林內鄉, 4482, 3064, 7546, 15551
c16, 雲林縣, 水林鄉, 4908, 3285, 8193, 22508
c16, 雲林縣, 臺西鄉, 5070, 3141, 8211, 21125
c16, 雲林縣, 莿桐鄉, 7018, 4785, 11803, 24570
c16, 雲林縣, 虎尾鎮, 16809, 11246, 28055, 58167
c16, 雲林縣, 褒忠鄉, 3057, 2066, 5123, 11381
c16, 雲林縣, 西螺鎮, 10492, 7068, 17560, 38142
c16, 雲林縣, 麥寮鄉, 9483, 6353, 15836, 37119
c16, 高雄市, , 752932, 509854, 1262786, 2353342
c16, 高雄市, 三民區, 92896, 64587, 157483, 289519
c16, 高雄市, 仁武區, 24041, 15653, 39694, 73611
c16, 高雄市, 內門區, 3171, 2190, 5361, 13002
c16, 高雄市, 六龜區, 2805, 1890, 4695, 11501
c16, 高雄市, 前金區, 7735, 5642, 13377, 23928
c16, 高雄市, 前鎮區, 51114, 35025, 86139, 161797
c16, 高雄市, 大寮區, 29648, 20901, 50549, 97309
c16, 高雄市, 大樹區, 10960, 7332, 18292, 36772
c16, 高雄市, 大社區, 9014, 6640, 15654, 30046
c16, 高雄市, 小港區, 42230, 28891, 71121, 132733
c16, 高雄市, 岡山區, 28342, 17486, 45828, 81244
c16, 高雄市, 左營區, 56269, 34699, 90968, 161367
c16, 高雄市, 彌陀區, 5293, 3704, 8997, 16487
c16, 高雄市, 新興區, 14213, 10807, 25020, 44355
c16, 高雄市, 旗山區, 9653, 6402, 16055, 31996
c16, 高雄市, 旗津區, 6331, 4756, 11087, 24860
c16, 高雄市, 杉林區, 2510, 1736, 4246, 10607
c16, 高雄市, 林園區, 17898, 11604, 29502, 59129
c16, 高雄市, 桃源區, 1024, 632, 1656, 3498
c16, 高雄市, 梓官區, 9540, 6643, 16183, 31025
c16, 高雄市, 楠梓區, 50610, 33271, 83881, 153132
c16, 高雄市, 橋頭區, 10396, 7679, 18075, 32565
c16, 高雄市, 永安區, 4103, 2707, 6810, 12001
c16, 高雄市, 湖內區, 7579, 5375, 12954, 25729
c16, 高雄市, 燕巢區, 8029, 5213, 13242, 26012
c16, 高雄市, 田寮區, 1690, 1101, 2791, 6671
c16, 高雄市, 甲仙區, 1329, 934, 2263, 5417
c16, 高雄市, 美濃區, 10310, 6967, 17277, 35311
c16, 高雄市, 苓雅區, 48433, 34428, 82861, 146786
c16, 高雄市, 茂林區, 637, 352, 989, 1615
c16, 高雄市, 茄萣區, 6925, 5453, 12378, 26212
c16, 高雄市, 路竹區, 13627, 9698, 23325, 43850
c16, 高雄市, 那瑪夏區, 745, 447, 1192, 2424
c16, 高雄市, 阿蓮區, 6890, 5125, 12015, 24534
c16, 高雄市, 鳥松區, 12625, 9306, 21931, 39191
c16, 高雄市, 鳳山區, 99747, 64662, 164409, 300510
c16, 高雄市, 鹽埕區, 6495, 4957, 11452, 21617
c16, 高雄市, 鼓山區, 38075, 24959, 63034, 114979
